"GISJOIN","GISJOIN_T","WHITE","BLACK","AM","ASIAN","OTHER","HISPANIC","POP"
"G11000100001101","G11000100001",244,13,0,7,7,27,298
"G11000100001102","G11000100001",22,0,0,13,13,0,48
"G11000100001103","G11000100001",34,0,0,0,0,1,35
"G11000100001104","G11000100001",96,0,0,0,0,4,100
"G11000100001105","G11000100001",39,0,0,1,1,4,45
"G11000100001106","G11000100001",84,1,0,5,5,3,98
"G11000100001107","G11000100001",93,1,0,1,1,15,111
"G11000100001108","G11000100001",163,0,0,9,9,12,193
"G11000100001109","G11000100001",124,1,0,3,3,1,132
"G11000100001110","G11000100001",93,0,0,3,3,12,111
"G11000100001111","G11000100001",105,4,0,5,5,6,125
"G11000100001112","G11000100001",46,0,0,1,1,5,53
"G11000100001201","G11000100001",541,29,1,18,18,15,622
"G11000100001202","G11000100001",270,29,0,7,7,33,346
"G11000100001203","G11000100001",48,1,0,0,0,1,50
"G11000100001204","G11000100001",71,12,0,1,1,6,91
"G11000100001205","G11000100001",58,0,1,1,1,1,62
"G11000100001207","G11000100001",75,2,0,0,0,1,78
"G11000100001208","G11000100001",50,0,0,0,0,0,50
"G11000100001209","G11000100001",31,1,0,0,0,1,33
"G11000100001303","G11000100001",13,0,0,0,0,0,13
"G11000100001304","G11000100001",12,0,0,5,5,0,22
"G11000100001307","G11000100001",16,0,0,0,0,0,16
"G11000100001308","G11000100001",41,1,0,6,6,5,59
"G11000100001309","G11000100001",4,0,0,0,0,0,4
"G11000100001310","G11000100001",112,0,0,4,4,5,125
"G11000100001312","G11000100001",30,0,0,4,4,0,38
"G11000100001401","G11000100001",50,2,0,1,1,6,60
"G11000100001402","G11000100001",76,1,0,1,1,2,81
"G11000100001403","G11000100001",56,5,0,1,1,1,64
"G11000100001404","G11000100001",60,1,0,2,2,0,65
"G11000100001405","G11000100001",32,1,0,1,1,1,36
"G11000100001406","G11000100001",42,2,0,1,1,2,48
"G11000100001407","G11000100001",43,4,1,2,2,1,53
"G11000100001408","G11000100001",60,2,0,0,0,1,63
"G11000100001409","G11000100001",85,0,0,4,4,5,98
"G11000100001410","G11000100001",84,0,0,1,1,2,88
"G11000100001501","G11000100001",70,3,0,2,2,9,86
"G11000100001502","G11000100001",135,5,0,5,5,7,157
"G11000100001503","G11000100001",50,4,0,1,1,0,56
"G11000100001504","G11000100001",47,0,0,0,0,5,52
"G11000100001505","G11000100001",48,0,0,0,0,0,48
"G11000100001506","G11000100001",49,1,0,2,2,0,54
"G11000100001507","G11000100001",130,3,0,2,2,6,143
"G11000100001508","G11000100001",64,1,0,4,4,8,81
"G11000100001509","G11000100001",46,0,0,1,1,0,48
"G11000100001510","G11000100001",136,13,0,6,6,0,161
"G11000100001511","G11000100001",52,0,0,2,2,8,64
"G11000100001512","G11000100001",120,2,0,3,3,1,129
"G11000100001513","G11000100001",42,2,0,3,3,6,56
"G11000100001514","G11000100001",83,0,0,6,6,4,99
"G1100010000201101","G1100010000201",2860,371,7,315,315,266,4134
"G1100010000202102","G1100010000202",122,4,2,21,21,11,181
"G1100010000202103","G1100010000202",37,0,0,0,0,2,39
"G1100010000202104","G1100010000202",51,0,0,2,2,2,57
"G1100010000202105","G1100010000202",102,0,0,3,3,6,114
"G1100010000202106","G1100010000202",66,5,0,1,1,5,78
"G1100010000202107","G1100010000202",297,4,0,6,6,18,331
"G1100010000202108","G1100010000202",108,0,0,1,1,10,120
"G1100010000202109","G1100010000202",24,0,1,5,5,0,35
"G1100010000202110","G1100010000202",106,0,0,1,1,3,111
"G1100010000202111","G1100010000202",79,1,0,0,0,3,83
"G1100010000202201","G1100010000202",63,1,0,1,1,5,71
"G1100010000202202","G1100010000202",23,0,0,1,1,1,26
"G1100010000202203","G1100010000202",64,1,0,1,1,4,71
"G1100010000202204","G1100010000202",50,0,0,1,1,2,54
"G1100010000202205","G1100010000202",114,1,0,0,0,6,121
"G1100010000202206","G1100010000202",76,2,0,3,3,2,86
"G1100010000202207","G1100010000202",75,0,1,5,5,3,89
"G1100010000202208","G1100010000202",95,2,0,3,3,8,111
"G1100010000202209","G1100010000202",107,2,0,4,4,2,119
"G1100010000202301","G1100010000202",92,0,0,1,1,9,103
"G1100010000202302","G1100010000202",53,0,0,0,0,0,53
"G1100010000202303","G1100010000202",55,0,0,2,2,8,67
"G1100010000202304","G1100010000202",78,2,0,7,7,9,103
"G1100010000202305","G1100010000202",11,2,0,0,0,1,14
"G1100010000202306","G1100010000202",44,1,0,5,5,1,56
"G1100010000202401","G1100010000202",105,4,0,2,2,12,125
"G1100010000202402","G1100010000202",2,0,0,0,0,0,2
"G1100010000202403","G1100010000202",2,1,0,0,0,0,3
"G1100010000202405","G1100010000202",57,2,0,1,1,2,63
"G1100010000202406","G1100010000202",150,6,0,21,21,0,198
"G1100010000202407","G1100010000202",12,1,0,0,0,6,19
"G1100010000202408","G1100010000202",60,2,0,0,0,6,68
"G1100010000202501","G1100010000202",83,2,0,0,0,8,93
"G1100010000202502","G1100010000202",89,0,0,0,0,1,90
"G1100010000202503","G1100010000202",102,1,0,0,0,5,108
"G1100010000202504","G1100010000202",78,3,0,2,2,5,90
"G1100010000202505","G1100010000202",95,0,0,2,2,5,104
"G1100010000202506","G1100010000202",65,0,0,0,0,1,66
"G1100010000202507","G1100010000202",32,0,0,0,0,0,32
"G1100010000202601","G1100010000202",83,5,0,3,3,1,95
"G1100010000202602","G1100010000202",59,2,0,3,3,2,69
"G1100010000202603","G1100010000202",16,1,0,0,0,0,17
"G1100010000202604","G1100010000202",75,0,0,2,2,3,82
"G1100010000202605","G1100010000202",3,0,0,1,1,0,5
"G1100010000202606","G1100010000202",66,2,1,3,3,1,76
"G1100010000202607","G1100010000202",7,0,0,2,2,0,11
"G1100010000202609","G1100010000202",34,0,1,5,5,2,47
"G1100010000310101","G1100010000310",207,3,0,5,5,14,234
"G1100010000310102","G1100010000310",58,1,0,2,2,17,80
"G1100010000310103","G1100010000310",150,5,0,3,3,8,169
"G1100010000310107","G1100010000310",212,7,0,8,8,6,241
"G1100010000310108","G1100010000310",87,2,0,4,4,4,101
"G1100010000310201","G1100010000310",147,3,0,10,10,4,174
"G1100010000310202","G1100010000310",124,4,0,6,6,5,145
"G1100010000310203","G1100010000310",92,4,0,6,6,3,111
"G1100010000310204","G1100010000310",108,1,0,6,6,2,123
"G1100010000310206","G1100010000310",37,0,0,1,1,0,39
"G1100010000310301","G1100010000310",812,24,3,32,32,36,939
"G1100010000310303","G1100010000310",105,1,0,3,3,1,113
"G1100010000310304","G1100010000310",87,0,0,1,1,6,95
"G1100010000310305","G1100010000310",81,7,0,2,2,10,102
"G1100010000310306","G1100010000310",119,1,0,4,4,3,131
"G1100010000310401","G1100010000310",113,1,0,14,14,6,148
"G1100010000310402","G1100010000310",199,2,0,13,13,3,230
"G1100010000310403","G1100010000310",175,1,0,5,5,9,195
"G1100010000310404","G1100010000310",108,4,0,2,2,3,119
"G1100010000310405","G1100010000310",85,3,0,1,1,5,95
"G1100010000310406","G1100010000310",91,4,0,3,3,1,102
"G1100010000310407","G1100010000310",168,1,1,6,6,7,189
"G1100010000310408","G1100010000310",119,6,0,3,3,3,134
"G1100010000310409","G1100010000310",0,0,0,0,0,0,0
"G1100010000310410","G1100010000310",106,2,0,5,5,3,121
"G1100010000310411","G1100010000310",111,3,0,2,2,6,124
"G1100010000310412","G1100010000310",107,1,0,1,1,4,114
"G1100010000310508","G1100010000310",521,46,1,43,43,49,703
"G1100010000310509","G1100010000310",110,19,0,6,6,27,168
"G1100010000310510","G1100010000310",48,8,0,2,2,2,62
"G1100010000310511","G1100010000310",183,10,2,2,2,15,214
"G1100010000310512","G1100010000310",136,4,1,3,3,8,155
"G1100010000310513","G1100010000310",116,8,0,4,4,9,141
"G1100010000310514","G1100010000310",124,0,0,0,0,5,129
"G11000100004101","G11000100004",5,0,0,0,0,0,5
"G11000100004102","G11000100004",39,0,2,1,1,3,46
"G11000100004103","G11000100004",38,2,0,2,2,4,48
"G11000100004104","G11000100004",9,0,0,7,7,0,23
"G11000100004105","G11000100004",53,0,0,1,1,3,58
"G11000100004106","G11000100004",39,4,1,0,0,1,45
"G11000100004108","G11000100004",16,0,0,0,0,1,17
"G11000100004109","G11000100004",42,0,0,1,1,5,49
"G11000100004110","G11000100004",27,0,0,0,0,1,28
"G11000100004111","G11000100004",37,3,1,2,2,0,45
"G11000100004112","G11000100004",42,0,0,0,0,3,45
"G11000100004115","G11000100004",53,1,0,5,5,5,69
"G11000100004116","G11000100004",20,1,0,0,0,2,23
"G11000100004117","G11000100004",24,0,0,0,0,1,25
"G11000100004118","G11000100004",56,0,0,5,5,2,68
"G11000100004120","G11000100004",16,0,0,0,0,0,16
"G11000100004121","G11000100004",36,1,1,3,3,0,44
"G11000100004201","G11000100004",17,0,0,0,0,0,17
"G11000100004202","G11000100004",10,4,0,4,4,1,23
"G11000100004203","G11000100004",2,0,0,5,5,0,12
"G11000100004204","G11000100004",10,0,0,3,3,21,37
"G11000100004205","G11000100004",5,10,0,2,2,5,24
"G11000100004206","G11000100004",24,6,0,3,3,6,42
"G11000100004207","G11000100004",21,0,0,0,0,3,24
"G11000100004209","G11000100004",8,0,0,1,1,0,10
"G11000100004210","G11000100004",24,6,0,6,6,0,42
"G11000100004211","G11000100004",35,0,0,0,0,0,35
"G11000100004212","G11000100004",81,0,0,4,4,7,96
"G11000100004213","G11000100004",15,1,0,3,3,2,24
"G11000100004214","G11000100004",24,1,0,0,0,0,25
"G11000100004215","G11000100004",111,4,0,4,4,3,126
"G11000100004216","G11000100004",36,0,0,3,3,15,57
"G11000100004217","G11000100004",1,0,0,1,1,0,3
"G11000100004218","G11000100004",1,0,0,0,0,7,8
"G11000100004219","G11000100004",86,4,0,12,12,12,126
"G11000100004221","G11000100004",10,0,0,0,0,1,11
"G1100010000501101","G1100010000501",20,4,0,0,0,0,24
"G1100010000501102","G1100010000501",341,22,0,18,18,34,433
"G1100010000501103","G1100010000501",383,29,1,16,16,39,484
"G1100010000501104","G1100010000501",201,2,0,12,12,6,233
"G1100010000501105","G1100010000501",81,2,0,7,7,10,107
"G1100010000501106","G1100010000501",226,12,0,7,7,18,270
"G1100010000501203","G1100010000501",2,5,0,0,0,6,13
"G1100010000501204","G1100010000501",7,0,0,0,0,0,7
"G1100010000501302","G1100010000501",1071,67,0,47,47,70,1302
"G1100010000502304","G1100010000502",166,4,0,5,5,11,191
"G1100010000502309","G1100010000502",22,1,0,0,0,2,25
"G1100010000502313","G1100010000502",174,0,0,10,10,0,194
"G1100010000502314","G1100010000502",254,5,0,13,13,35,320
"G1100010000502315","G1100010000502",220,18,1,18,18,30,305
"G1100010000502316","G1100010000502",257,22,2,10,10,121,422
"G1100010000502320","G1100010000502",2,0,0,0,0,0,2
"G1100010000502321","G1100010000502",119,0,0,2,2,7,130
"G1100010000502401","G1100010000502",602,24,0,28,28,43,725
"G1100010000502402","G1100010000502",219,8,0,8,8,6,249
"G1100010000502403","G1100010000502",135,9,1,6,6,37,194
"G1100010000502404","G1100010000502",62,6,0,0,0,2,70
"G1100010000502405","G1100010000502",141,0,0,14,14,2,171
"G1100010000502406","G1100010000502",46,0,0,2,2,1,51
"G1100010000502410","G1100010000502",424,15,1,7,7,36,490
"G1100010000502501","G1100010000502",83,0,0,1,1,1,86
"G1100010000502502","G1100010000502",112,4,0,3,3,5,127
"G1100010000502503","G1100010000502",15,0,0,1,1,0,17
"G1100010000502504","G1100010000502",75,4,0,1,1,1,82
"G1100010000502505","G1100010000502",38,0,0,3,3,4,48
"G1100010000502506","G1100010000502",39,0,0,0,0,6,45
"G11000100006101","G11000100006",290,3,0,2,2,4,301
"G11000100006102","G11000100006",156,7,0,5,5,9,182
"G11000100006104","G11000100006",77,4,0,4,4,7,96
"G11000100006105","G11000100006",39,0,0,0,0,0,39
"G11000100006106","G11000100006",366,28,1,14,14,133,556
"G11000100006201","G11000100006",135,10,0,27,27,56,255
"G11000100006202","G11000100006",85,7,0,7,7,42,148
"G11000100006203","G11000100006",86,2,0,1,1,6,96
"G11000100006204","G11000100006",49,2,0,0,0,3,54
"G11000100006205","G11000100006",39,0,0,1,1,0,41
"G11000100006206","G11000100006",258,12,0,3,3,8,284
"G11000100006207","G11000100006",163,6,0,7,7,6,189
"G11000100006209","G11000100006",50,0,0,0,0,12,62
"G11000100006210","G11000100006",62,1,0,1,1,2,67
"G11000100006301","G11000100006",55,0,0,0,0,0,55
"G11000100006302","G11000100006",118,3,0,8,8,46,183
"G11000100006303","G11000100006",56,1,0,1,1,0,59
"G11000100006304","G11000100006",66,0,0,0,0,2,68
"G11000100006305","G11000100006",56,2,0,1,1,0,60
"G11000100006306","G11000100006",40,0,0,1,1,1,43
"G11000100006307","G11000100006",215,245,0,9,9,7,485
"G11000100006308","G11000100006",47,0,0,1,1,5,54
"G11000100006401","G11000100006",93,2,0,9,9,6,119
"G11000100006402","G11000100006",49,0,0,5,5,3,62
"G11000100006403","G11000100006",43,0,0,0,0,0,43
"G11000100006404","G11000100006",56,3,0,0,0,5,64
"G11000100006405","G11000100006",207,8,0,15,15,20,265
"G11000100006406","G11000100006",75,0,0,6,6,6,93
"G11000100006407","G11000100006",75,0,0,8,8,3,94
"G11000100006408","G11000100006",14,0,0,0,0,0,14
"G11000100006409","G11000100006",100,4,0,11,11,12,138
"G11000100006410","G11000100006",29,0,0,0,0,2,31
"G11000100006411","G11000100006",86,3,0,1,1,5,96
"G11000100006412","G11000100006",66,8,4,1,1,6,86
"G11000100006413","G11000100006",70,1,0,2,2,0,75
"G11000100006501","G11000100006",88,3,0,1,1,1,94
"G11000100006502","G11000100006",82,0,0,2,2,1,87
"G11000100006503","G11000100006",123,0,0,2,2,5,132
"G11000100006504","G11000100006",44,0,0,1,1,1,47
"G11000100006506","G11000100006",146,43,0,0,0,3,192
"G1100010000701101","G1100010000701",272,41,1,28,28,107,477
"G1100010000701102","G1100010000701",639,72,1,58,58,253,1081
"G1100010000701104","G1100010000701",64,0,0,1,1,0,66
"G1100010000701105","G1100010000701",65,3,0,4,4,6,82
"G1100010000701106","G1100010000701",20,0,1,0,0,0,21
"G1100010000701107","G1100010000701",54,0,0,0,0,0,54
"G1100010000701201","G1100010000701",397,23,0,10,10,20,460
"G1100010000701202","G1100010000701",225,6,0,19,19,12,281
"G1100010000701203","G1100010000701",4,0,0,0,0,0,4
"G1100010000701204","G1100010000701",69,1,1,11,11,1,94
"G1100010000701205","G1100010000701",53,13,0,6,6,33,111
"G1100010000701206","G1100010000701",62,1,0,0,0,4,67
"G1100010000701207","G1100010000701",70,5,0,0,0,7,82
"G1100010000701208","G1100010000701",1172,14,1,9,9,34,1239
"G1100010000701209","G1100010000701",73,5,0,5,5,9,97
"G1100010000701210","G1100010000701",55,1,0,4,4,2,66
"G1100010000701211","G1100010000701",60,3,0,1,1,1,66
"G1100010000701212","G1100010000701",272,16,1,18,18,43,368
"G1100010000701213","G1100010000701",27,0,0,0,0,3,30
"G1100010000701214","G1100010000701",5,0,0,0,0,0,5
"G1100010000720305","G1100010000720",810,80,0,57,57,109,1113
"G1100010000720306","G1100010000720",58,0,0,1,1,4,64
"G1100010000720307","G1100010000720",426,38,0,87,87,69,707
"G1100010000720308","G1100010000720",206,12,1,16,16,47,298
"G1100010000720501","G1100010000720",462,13,0,21,21,27,544
"G1100010000720503","G1100010000720",158,12,0,16,16,20,222
"G1100010000720504","G1100010000720",224,28,1,19,19,37,328
"G1100010000720506","G1100010000720",225,4,0,12,12,9,262
"G1100010000801101","G1100010000801",2375,86,0,93,93,167,2814
"G1100010000801102","G1100010000801",8,0,0,0,0,4,12
"G1100010000801103","G1100010000801",34,0,0,1,1,1,37
"G1100010000801104","G1100010000801",39,0,0,1,1,4,45
"G1100010000801105","G1100010000801",60,0,0,0,0,0,60
"G1100010000801106","G1100010000801",3,0,0,0,0,0,3
"G1100010000801107","G1100010000801",248,10,0,13,13,13,297
"G1100010000801108","G1100010000801",18,0,0,1,1,0,20
"G1100010000801109","G1100010000801",11,0,0,0,0,0,11
"G1100010000801110","G1100010000801",38,0,1,1,1,4,45
"G1100010000801201","G1100010000801",159,5,0,0,0,7,171
"G1100010000801401","G1100010000801",262,49,1,10,10,22,354
"G1100010000801402","G1100010000801",19,1,0,0,0,1,21
"G1100010000801403","G1100010000801",232,30,0,11,11,9,293
"G1100010000801404","G1100010000801",0,0,0,0,0,0,0
"G1100010000801405","G1100010000801",24,0,0,4,4,0,32
"G1100010000801406","G1100010000801",93,1,1,3,3,4,105
"G1100010000801407","G1100010000801",59,0,0,4,4,1,68
"G1100010000801409","G1100010000801",13,0,0,1,1,3,18
"G1100010000801410","G1100010000801",23,0,0,1,1,4,29
"G1100010000801501","G1100010000801",37,1,0,1,1,2,42
"G1100010000801502","G1100010000801",93,3,0,0,0,1,97
"G1100010000801503","G1100010000801",76,0,0,0,0,1,77
"G1100010000801504","G1100010000801",17,0,0,0,0,1,18
"G1100010000801505","G1100010000801",155,0,0,13,13,6,187
"G1100010000801506","G1100010000801",13,0,0,0,0,1,14
"G1100010000801507","G1100010000801",23,0,0,0,0,0,23
"G1100010000801508","G1100010000801",70,1,0,0,0,8,79
"G1100010000801520","G1100010000801",98,1,1,6,6,13,125
"G1100010000801521","G1100010000801",200,5,0,9,9,16,239
"G1100010000801601","G1100010000801",42,0,0,2,2,2,48
"G1100010000801602","G1100010000801",31,0,0,2,2,0,35
"G1100010000801603","G1100010000801",28,3,0,1,1,1,34
"G1100010000801604","G1100010000801",41,0,0,0,0,1,42
"G1100010000801605","G1100010000801",39,0,0,1,1,1,42
"G1100010000801606","G1100010000801",51,0,0,1,1,5,58
"G1100010000801607","G1100010000801",52,0,0,1,1,4,58
"G1100010000801608","G1100010000801",50,0,0,0,0,3,53
"G1100010000801609","G1100010000801",56,3,0,1,1,0,61
"G1100010000801611","G1100010000801",23,0,0,1,1,5,30
"G1100010000801612","G1100010000801",69,1,0,2,2,0,74
"G1100010000801613","G1100010000801",1,0,0,0,0,0,1
"G1100010000801614","G1100010000801",63,0,0,1,1,1,66
"G1100010000801615","G1100010000801",67,0,0,1,1,1,70
"G1100010000801616","G1100010000801",30,1,0,2,2,0,35
"G1100010000801617","G1100010000801",62,6,0,0,0,2,70
"G1100010000802201","G1100010000802",25,0,0,3,3,9,40
"G1100010000802202","G1100010000802",169,5,0,6,6,7,193
"G1100010000802204","G1100010000802",20,0,0,1,1,0,22
"G1100010000802205","G1100010000802",33,0,0,1,1,2,37
"G1100010000802206","G1100010000802",24,1,0,2,2,0,29
"G1100010000802207","G1100010000802",112,3,0,2,2,5,124
"G1100010000802209","G1100010000802",83,0,0,3,3,4,93
"G1100010000802210","G1100010000802",93,1,0,10,10,8,122
"G1100010000802211","G1100010000802",39,0,0,1,1,1,42
"G1100010000802214","G1100010000802",124,5,1,3,3,6,142
"G1100010000802215","G1100010000802",74,0,0,1,1,6,82
"G1100010000802220","G1100010000802",152,0,0,2,2,6,162
"G1100010000802301","G1100010000802",44,0,0,0,0,5,49
"G1100010000802302","G1100010000802",74,1,0,1,1,3,80
"G1100010000802303","G1100010000802",29,0,0,0,0,1,30
"G1100010000802304","G1100010000802",43,0,0,10,10,4,67
"G1100010000802305","G1100010000802",38,4,0,7,7,0,56
"G1100010000802306","G1100010000802",35,0,0,2,2,3,42
"G1100010000802307","G1100010000802",97,0,0,2,2,2,103
"G1100010000802308","G1100010000802",213,38,4,10,10,11,286
"G1100010000802310","G1100010000802",64,1,0,2,2,4,73
"G1100010000802311","G1100010000802",17,0,0,0,0,0,17
"G1100010000802312","G1100010000802",119,12,1,5,5,13,155
"G1100010000802320","G1100010000802",389,19,0,16,16,48,488
"G1100010000802321","G1100010000802",198,12,1,20,20,15,266
"G1100010000901102","G1100010000901",17,0,0,8,8,0,33
"G1100010000901103","G1100010000901",79,0,0,12,12,5,108
"G1100010000901104","G1100010000901",30,1,0,1,1,0,33
"G1100010000901105","G1100010000901",44,0,0,5,5,7,61
"G1100010000901106","G1100010000901",37,5,0,3,3,4,52
"G1100010000901107","G1100010000901",36,0,0,0,0,0,36
"G1100010000901109","G1100010000901",58,0,0,2,2,15,77
"G1100010000901110","G1100010000901",48,0,0,0,0,0,48
"G1100010000901111","G1100010000901",44,0,0,2,2,3,51
"G1100010000901112","G1100010000901",32,1,0,5,5,1,44
"G1100010000901114","G1100010000901",28,1,0,0,0,1,30
"G1100010000901115","G1100010000901",41,0,0,0,0,2,43
"G1100010000901116","G1100010000901",40,0,0,2,2,15,59
"G1100010000901201","G1100010000901",50,0,0,0,0,1,51
"G1100010000901202","G1100010000901",62,0,0,6,6,2,76
"G1100010000901203","G1100010000901",2735,196,6,166,166,190,3459
"G1100010000901206","G1100010000901",59,2,0,9,9,1,80
"G1100010000901207","G1100010000901",20,0,0,5,5,1,31
"G1100010000901208","G1100010000901",47,0,0,3,3,1,54
"G1100010000901209","G1100010000901",76,17,0,1,1,25,120
"G1100010000901601","G1100010000901",280,11,0,31,31,21,374
"G1100010000901602","G1100010000901",16,11,0,1,1,0,29
"G1100010000901603","G1100010000901",54,0,0,5,5,3,67
"G1100010000901604","G1100010000901",85,0,0,3,3,1,92
"G1100010000901605","G1100010000901",62,0,0,2,2,1,67
"G1100010000901606","G1100010000901",138,0,0,5,5,8,156
"G1100010000901607","G1100010000901",28,5,0,1,1,5,40
"G1100010000901608","G1100010000901",35,12,0,1,1,2,51
"G1100010000901609","G1100010000901",33,11,0,0,0,0,44
"G1100010000901610","G1100010000901",58,0,0,3,3,2,66
"G1100010000901612","G1100010000901",67,0,0,11,11,7,96
"G1100010000901613","G1100010000901",108,2,0,2,2,9,123
"G1100010000901614","G1100010000901",103,0,0,4,4,4,115
"G1100010000901615","G1100010000901",23,0,0,1,1,0,25
"G1100010000901616","G1100010000901",44,0,0,0,0,3,47
"G1100010000901617","G1100010000901",61,0,0,6,6,10,83
"G1100010000901702","G1100010000901",320,2,0,20,20,17,379
"G1100010000901704","G1100010000901",3,1,0,0,0,0,4
"G1100010000901705","G1100010000901",23,0,0,0,0,4,27
"G1100010000901706","G1100010000901",63,0,0,0,0,0,63
"G1100010000901707","G1100010000901",112,2,0,0,0,16,130
"G1100010000901708","G1100010000901",48,1,0,0,0,1,50
"G1100010000901709","G1100010000901",75,0,0,3,3,3,84
"G1100010000901710","G1100010000901",103,1,0,6,6,1,117
"G1100010000901711","G1100010000901",75,0,1,1,1,1,79
"G1100010000901712","G1100010000901",33,0,0,0,0,1,34
"G1100010000901713","G1100010000901",39,0,0,0,0,2,41
"G1100010000901714","G1100010000901",35,0,0,4,4,5,48
"G1100010000901715","G1100010000901",29,0,0,1,1,3,34
"G1100010000901716","G1100010000901",43,3,0,0,0,12,58
"G1100010000902301","G1100010000902",309,15,0,15,15,10,364
"G1100010000902302","G1100010000902",107,2,0,5,5,6,125
"G1100010000902303","G1100010000902",74,0,0,1,1,1,77
"G1100010000902304","G1100010000902",87,1,0,2,2,1,93
"G1100010000902305","G1100010000902",32,4,0,0,0,4,40
"G1100010000902306","G1100010000902",21,0,0,5,5,1,32
"G1100010000902307","G1100010000902",15,4,0,0,0,0,19
"G1100010000902401","G1100010000902",35,0,0,0,0,17,52
"G1100010000902402","G1100010000902",21,3,0,0,0,0,24
"G1100010000902404","G1100010000902",11,10,0,0,0,1,22
"G1100010000902405","G1100010000902",26,0,0,0,0,1,27
"G1100010000902406","G1100010000902",139,12,0,8,8,1,168
"G1100010000902411","G1100010000902",96,3,0,9,9,5,122
"G1100010000902412","G1100010000902",45,0,0,2,2,2,51
"G1100010000902501","G1100010000902",33,1,0,2,2,0,38
"G1100010000902503","G1100010000902",27,6,0,0,0,1,34
"G1100010000902504","G1100010000902",51,1,0,1,1,0,54
"G1100010000902505","G1100010000902",57,0,0,1,1,0,59
"G1100010000902506","G1100010000902",42,0,0,0,0,1,43
"G1100010000902507","G1100010000902",47,4,0,2,2,6,61
"G1100010000902508","G1100010000902",28,0,0,0,0,1,29
"G1100010000902509","G1100010000902",32,3,0,2,2,4,43
"G1100010000902511","G1100010000902",53,0,0,0,0,1,54
"G1100010000902512","G1100010000902",41,10,0,0,0,0,51
"G1100010000902516","G1100010000902",40,1,0,0,0,1,42
"G1100010000902517","G1100010000902",79,0,0,1,1,1,82
"G1100010000902518","G1100010000902",43,3,0,0,0,0,46
"G1100010000902519","G1100010000902",50,1,0,4,4,0,59
"G1100010000902520","G1100010000902",24,1,0,2,2,1,30
"G1100010000902521","G1100010000902",67,6,0,2,2,1,78
"G1100010001001104","G1100010001001",46,6,0,2,2,3,59
"G1100010001001105","G1100010001001",50,7,0,6,6,11,80
"G1100010001001107","G1100010001001",38,0,0,7,7,5,57
"G1100010001001109","G1100010001001",71,0,0,1,1,10,83
"G1100010001001110","G1100010001001",24,5,0,2,2,6,39
"G1100010001001111","G1100010001001",66,1,0,2,2,3,74
"G1100010001001112","G1100010001001",59,4,0,8,8,0,79
"G1100010001001113","G1100010001001",89,5,0,2,2,24,122
"G1100010001001114","G1100010001001",10,0,0,0,0,3,13
"G1100010001001115","G1100010001001",84,5,0,5,5,6,105
"G1100010001001201","G1100010001001",42,1,0,1,1,6,51
"G1100010001001202","G1100010001001",44,4,0,2,2,1,53
"G1100010001001203","G1100010001001",54,2,0,1,1,3,61
"G1100010001001204","G1100010001001",59,0,0,2,2,1,64
"G1100010001001205","G1100010001001",10,0,0,1,1,2,14
"G1100010001001206","G1100010001001",68,1,0,3,3,9,84
"G1100010001001208","G1100010001001",47,0,0,6,6,8,67
"G1100010001001209","G1100010001001",8,0,0,2,2,0,12
"G1100010001001210","G1100010001001",73,0,0,0,0,3,76
"G1100010001001211","G1100010001001",74,1,0,5,5,1,86
"G1100010001001212","G1100010001001",44,0,0,8,8,1,61
"G1100010001001301","G1100010001001",40,0,0,4,4,7,55
"G1100010001001302","G1100010001001",19,0,0,0,0,0,19
"G1100010001001303","G1100010001001",72,5,0,6,6,12,101
"G1100010001001304","G1100010001001",69,1,0,4,4,0,78
"G1100010001001305","G1100010001001",59,0,0,0,0,5,64
"G1100010001001306","G1100010001001",54,2,0,4,4,1,65
"G1100010001001307","G1100010001001",46,4,0,0,0,1,51
"G1100010001001308","G1100010001001",61,0,0,4,4,0,69
"G1100010001001309","G1100010001001",60,1,1,5,5,7,79
"G1100010001001310","G1100010001001",19,0,0,4,4,0,27
"G1100010001001311","G1100010001001",47,1,0,0,0,1,49
"G1100010001001312","G1100010001001",47,0,0,1,1,3,52
"G1100010001001313","G1100010001001",10,0,0,0,0,1,11
"G1100010001001314","G1100010001001",16,0,0,0,0,2,18
"G1100010001001315","G1100010001001",186,20,0,0,0,4,210
"G1100010001001401","G1100010001001",15,0,0,0,0,6,21
"G1100010001001402","G1100010001001",47,1,0,0,0,0,48
"G1100010001001403","G1100010001001",17,1,0,0,0,0,18
"G1100010001001404","G1100010001001",55,0,0,0,0,0,55
"G1100010001001405","G1100010001001",52,3,0,2,2,2,61
"G1100010001001406","G1100010001001",52,0,0,1,1,3,57
"G1100010001001407","G1100010001001",60,0,0,0,0,18,78
"G1100010001001408","G1100010001001",42,4,0,6,6,0,58
"G1100010001001409","G1100010001001",55,0,0,1,1,2,59
"G1100010001001410","G1100010001001",66,1,0,2,2,8,79
"G1100010001001411","G1100010001001",9,0,0,2,2,0,13
"G1100010001001412","G1100010001001",3,0,0,0,0,0,3
"G1100010001001413","G1100010001001",56,0,0,0,0,2,58
"G1100010001001414","G1100010001001",59,1,0,0,0,6,66
"G1100010001001415","G1100010001001",44,1,0,3,3,2,53
"G1100010001001416","G1100010001001",41,0,0,3,3,3,50
"G1100010001001417","G1100010001001",5,0,0,0,0,0,5
"G1100010001001418","G1100010001001",215,96,0,34,34,28,407
"G1100010001001419","G1100010001001",28,1,0,0,0,12,41
"G1100010001001502","G1100010001001",63,6,0,4,4,2,79
"G1100010001001503","G1100010001001",44,2,0,9,9,1,65
"G1100010001001504","G1100010001001",63,15,0,14,14,2,108
"G1100010001001506","G1100010001001",30,0,0,0,0,1,31
"G1100010001001507","G1100010001001",23,0,0,0,0,0,23
"G1100010001001601","G1100010001001",50,1,0,0,0,1,52
"G1100010001001602","G1100010001001",41,0,0,0,0,3,44
"G1100010001001603","G1100010001001",42,0,0,0,0,4,46
"G1100010001001604","G1100010001001",41,0,0,0,0,0,41
"G1100010001001605","G1100010001001",59,0,0,2,2,7,70
"G1100010001001606","G1100010001001",54,0,0,1,1,1,57
"G1100010001001607","G1100010001001",56,0,0,0,0,1,57
"G1100010001001608","G1100010001001",44,0,0,1,1,0,46
"G1100010001001609","G1100010001001",57,0,0,4,4,7,72
"G1100010001001610","G1100010001001",27,0,0,0,0,2,29
"G1100010001001611","G1100010001001",32,0,0,4,4,0,40
"G1100010001001612","G1100010001001",60,0,0,0,0,0,60
"G1100010001001615","G1100010001001",57,0,0,6,6,5,74
"G1100010001001616","G1100010001001",49,3,0,1,1,10,64
"G1100010001001617","G1100010001001",35,1,0,0,0,2,38
"G1100010001001618","G1100010001001",34,0,0,2,2,1,39
"G1100010001001619","G1100010001001",34,0,0,0,0,0,34
"G1100010001001620","G1100010001001",40,2,0,0,0,0,42
"G1100010001001621","G1100010001001",42,4,0,1,1,8,56
"G1100010001001622","G1100010001001",51,1,0,0,0,0,52
"G1100010001001701","G1100010001001",46,2,0,0,0,0,48
"G1100010001001702","G1100010001001",40,0,0,0,0,0,40
"G1100010001001703","G1100010001001",45,0,0,0,0,0,45
"G1100010001001704","G1100010001001",44,0,0,4,4,3,55
"G1100010001001705","G1100010001001",72,1,0,1,1,3,78
"G1100010001001706","G1100010001001",81,1,0,0,0,7,89
"G1100010001001707","G1100010001001",46,1,0,3,3,1,54
"G1100010001001708","G1100010001001",54,3,0,2,2,5,66
"G1100010001001709","G1100010001001",36,0,0,7,7,6,56
"G1100010001001711","G1100010001001",45,0,0,4,4,0,53
"G1100010001001712","G1100010001001",55,9,0,1,1,2,68
"G1100010001001713","G1100010001001",46,1,1,5,5,2,60
"G1100010001001714","G1100010001001",39,2,0,0,0,2,43
"G1100010001001715","G1100010001001",65,0,0,0,0,3,68
"G1100010001001716","G1100010001001",54,10,0,3,3,1,71
"G1100010001001718","G1100010001001",39,0,0,2,2,0,43
"G1100010001001719","G1100010001001",62,0,0,2,2,5,71
"G1100010001001801","G1100010001001",21,0,0,0,0,2,23
"G1100010001001802","G1100010001001",55,0,0,0,0,1,56
"G1100010001001803","G1100010001001",62,1,0,1,1,1,66
"G1100010001001804","G1100010001001",43,1,0,0,0,0,44
"G1100010001001805","G1100010001001",50,2,0,0,0,0,52
"G1100010001001806","G1100010001001",44,1,0,1,1,3,50
"G1100010001001807","G1100010001001",46,1,0,1,1,4,53
"G1100010001001808","G1100010001001",44,0,0,2,2,0,48
"G1100010001001809","G1100010001001",71,0,0,1,1,1,74
"G1100010001001811","G1100010001001",46,2,0,0,0,0,48
"G1100010001001812","G1100010001001",43,0,0,1,1,1,46
"G1100010001001816","G1100010001001",53,0,0,0,0,0,53
"G1100010001001817","G1100010001001",64,0,0,3,3,3,73
"G1100010001001819","G1100010001001",25,0,0,1,1,0,27
"G1100010001001821","G1100010001001",2,0,0,0,0,0,2
"G1100010001002101","G1100010001002",23,0,0,0,0,0,23
"G1100010001002103","G1100010001002",64,37,1,0,0,2,104
"G1100010001002105","G1100010001002",1474,103,2,143,143,148,2013
"G1100010001002106","G1100010001002",32,0,0,5,5,0,42
"G1100010001002201","G1100010001002",198,7,0,6,6,17,234
"G1100010001002203","G1100010001002",304,41,1,19,19,42,426
"G1100010001002204","G1100010001002",287,19,2,23,23,24,378
"G1100010001002205","G1100010001002",183,48,0,41,41,53,366
"G1100010001002207","G1100010001002",95,8,0,12,12,17,144
"G1100010001002208","G1100010001002",41,0,0,1,1,1,44
"G11000100011101","G11000100011",9,1,0,0,0,2,12
"G11000100011103","G11000100011",20,0,0,1,1,0,22
"G11000100011106","G11000100011",4,0,0,1,1,0,6
"G11000100011108","G11000100011",15,0,0,1,1,0,17
"G11000100011109","G11000100011",51,0,0,5,5,1,62
"G11000100011111","G11000100011",24,0,0,2,2,3,31
"G11000100011112","G11000100011",106,0,0,2,2,4,114
"G11000100011113","G11000100011",105,4,0,1,1,1,112
"G11000100011114","G11000100011",46,0,0,9,9,0,64
"G11000100011201","G11000100011",340,10,0,4,4,4,362
"G11000100011202","G11000100011",104,1,0,7,7,7,126
"G11000100011212","G11000100011",52,0,0,0,0,5,57
"G11000100011213","G11000100011",117,2,0,8,8,7,142
"G11000100011214","G11000100011",71,1,0,3,3,4,82
"G11000100011216","G11000100011",15,5,0,3,3,0,26
"G11000100011217","G11000100011",48,0,0,0,0,0,48
"G11000100011218","G11000100011",51,0,0,0,0,1,52
"G11000100011219","G11000100011",42,3,0,0,0,4,49
"G11000100011220","G11000100011",342,25,1,24,24,42,458
"G11000100011221","G11000100011",30,4,0,4,4,0,42
"G11000100011222","G11000100011",24,0,0,3,3,0,30
"G11000100011223","G11000100011",51,2,1,3,3,5,65
"G11000100011301","G11000100011",58,0,0,0,0,1,59
"G11000100011302","G11000100011",71,4,0,0,0,0,75
"G11000100011304","G11000100011",28,2,0,0,0,0,30
"G11000100011305","G11000100011",63,0,0,3,3,1,70
"G11000100011306","G11000100011",58,5,0,0,0,2,65
"G11000100011314","G11000100011",63,0,0,1,1,0,65
"G11000100011315","G11000100011",165,19,1,14,14,29,242
"G11000100011316","G11000100011",16,4,0,0,0,1,21
"G11000100011401","G11000100011",57,2,0,0,0,0,59
"G11000100011402","G11000100011",43,0,0,1,1,3,48
"G11000100011403","G11000100011",24,0,0,0,0,4,28
"G11000100011404","G11000100011",23,0,0,8,8,0,39
"G11000100011405","G11000100011",34,0,0,2,2,0,38
"G11000100011407","G11000100011",59,0,0,3,3,1,66
"G11000100011408","G11000100011",1,1,0,0,0,0,2
"G11000100011411","G11000100011",8,0,0,0,0,0,8
"G11000100011412","G11000100011",15,2,0,0,0,0,17
"G11000100011413","G11000100011",0,0,0,0,0,0,0
"G11000100011417","G11000100011",0,0,0,0,0,0,0
"G11000100011418","G11000100011",0,0,0,0,0,0,0
"G11000100011419","G11000100011",0,0,0,0,0,0,0
"G11000100011420","G11000100011",41,2,0,1,1,2,47
"G11000100011421","G11000100011",36,5,0,0,0,0,41
"G11000100011422","G11000100011",48,0,0,3,3,2,56
"G11000100011423","G11000100011",32,0,0,0,0,0,32
"G11000100011424","G11000100011",35,1,0,0,0,5,41
"G11000100011428","G11000100011",43,3,0,0,0,1,47
"G11000100011429","G11000100011",47,2,0,0,0,7,56
"G11000100011431","G11000100011",46,2,0,7,7,0,62
"G11000100011501","G11000100011",33,2,0,2,2,3,42
"G11000100011502","G11000100011",61,3,0,8,8,3,83
"G11000100011503","G11000100011",25,0,0,0,0,4,29
"G11000100011504","G11000100011",59,4,1,1,1,5,71
"G11000100011505","G11000100011",50,0,0,1,1,0,52
"G11000100011506","G11000100011",29,0,0,0,0,0,29
"G11000100011507","G11000100011",49,5,0,2,2,5,63
"G11000100011509","G11000100011",26,0,0,0,0,0,26
"G11000100011510","G11000100011",53,0,0,5,5,0,63
"G11000100011511","G11000100011",54,2,0,2,2,0,60
"G11000100011512","G11000100011",38,0,0,0,0,0,38
"G11000100011514","G11000100011",18,0,0,1,1,0,20
"G11000100011515","G11000100011",59,0,0,6,6,0,71
"G11000100011516","G11000100011",63,0,0,1,1,2,67
"G11000100011519","G11000100011",30,5,0,2,2,1,40
"G11000100011520","G11000100011",52,19,0,0,0,1,72
"G11000100011523","G11000100011",73,3,0,1,1,2,80
"G11000100011524","G11000100011",70,0,0,13,13,8,104
"G11000100011525","G11000100011",68,4,0,7,7,6,92
"G11000100011526","G11000100011",106,1,1,2,2,0,112
"G11000100011527","G11000100011",41,0,0,2,2,0,45
"G11000100011528","G11000100011",30,1,0,5,5,0,41
"G11000100012102","G11000100012",482,84,1,50,50,49,716
"G11000100012103","G11000100012",229,15,1,15,15,12,287
"G11000100012104","G11000100012",23,0,0,1,1,3,28
"G11000100012105","G11000100012",19,5,0,3,3,2,32
"G11000100012106","G11000100012",6,3,0,0,0,0,9
"G11000100012107","G11000100012",46,0,0,0,0,0,46
"G11000100012109","G11000100012",33,0,0,0,0,2,35
"G11000100012110","G11000100012",109,1,0,0,0,2,112
"G11000100012111","G11000100012",331,22,0,30,30,24,437
"G11000100012112","G11000100012",43,1,0,1,1,4,50
"G11000100012113","G11000100012",52,2,0,3,3,3,63
"G11000100012114","G11000100012",14,2,0,0,0,0,16
"G11000100012201","G11000100012",107,15,0,4,4,6,136
"G11000100012202","G11000100012",76,1,0,4,4,1,86
"G11000100012203","G11000100012",238,16,0,21,21,14,310
"G11000100012204","G11000100012",62,3,0,2,2,2,71
"G11000100012206","G11000100012",33,1,0,0,0,1,35
"G11000100012207","G11000100012",39,0,1,0,0,1,41
"G11000100012208","G11000100012",283,27,0,2,2,6,320
"G11000100012301","G11000100012",104,18,0,7,7,37,173
"G11000100012302","G11000100012",74,3,0,0,0,9,86
"G11000100012303","G11000100012",49,0,0,3,3,5,60
"G11000100012304","G11000100012",47,1,0,0,0,10,58
"G11000100012305","G11000100012",54,3,0,0,0,1,58
"G11000100012306","G11000100012",6,0,0,0,0,7,13
"G11000100012307","G11000100012",14,0,0,0,0,1,15
"G11000100012308","G11000100012",54,0,0,0,0,0,54
"G11000100012309","G11000100012",66,0,0,2,2,12,82
"G11000100012310","G11000100012",43,0,0,2,2,0,47
"G11000100012311","G11000100012",39,3,0,1,1,2,46
"G11000100012401","G11000100012",38,1,0,1,1,1,42
"G11000100012402","G11000100012",7,2,0,0,0,0,9
"G11000100012403","G11000100012",84,0,0,4,4,3,95
"G11000100012404","G11000100012",102,0,0,4,4,3,113
"G11000100012405","G11000100012",94,1,1,4,4,3,107
"G11000100012407","G11000100012",44,1,0,0,0,0,45
"G11000100012408","G11000100012",38,1,0,5,5,2,51
"G11000100012409","G11000100012",15,0,0,0,0,0,15
"G11000100012501","G11000100012",62,0,0,3,3,3,71
"G11000100012502","G11000100012",45,1,2,2,2,7,59
"G11000100012503","G11000100012",49,1,0,1,1,0,52
"G11000100012504","G11000100012",8,0,0,0,0,1,9
"G11000100012505","G11000100012",69,2,2,3,3,4,83
"G11000100012506","G11000100012",72,0,1,0,0,5,78
"G11000100012507","G11000100012",65,0,0,2,2,4,73
"G11000100012508","G11000100012",58,2,0,1,1,4,66
"G11000100012509","G11000100012",10,0,0,0,0,0,10
"G11000100012510","G11000100012",73,2,0,4,4,8,91
"G11000100012512","G11000100012",58,0,0,6,6,0,70
"G11000100012513","G11000100012",61,2,0,3,3,0,69
"G11000100012514","G11000100012",109,19,0,19,19,137,303
"G1100010001301103","G1100010001301",0,0,0,0,0,0,0
"G1100010001301105","G1100010001301",155,19,1,1,1,2,179
"G1100010001301107","G1100010001301",67,0,0,5,5,5,82
"G1100010001301111","G1100010001301",51,0,0,6,6,1,64
"G1100010001301401","G1100010001301",670,38,1,36,36,39,820
"G1100010001301402","G1100010001301",10,8,0,0,0,0,18
"G1100010001301403","G1100010001301",54,2,0,1,1,5,63
"G1100010001301404","G1100010001301",78,1,0,2,2,3,86
"G1100010001301405","G1100010001301",27,1,0,0,0,1,29
"G1100010001301406","G1100010001301",38,0,0,0,0,0,38
"G1100010001301407","G1100010001301",92,3,0,2,2,2,101
"G1100010001301501","G1100010001301",61,5,0,2,2,2,72
"G1100010001301502","G1100010001301",23,2,0,0,0,0,25
"G1100010001301503","G1100010001301",45,3,0,0,0,1,49
"G1100010001301504","G1100010001301",39,5,0,1,1,0,46
"G1100010001301505","G1100010001301",14,0,0,0,0,0,14
"G1100010001301506","G1100010001301",171,26,0,2,2,5,206
"G1100010001301507","G1100010001301",6,8,0,1,1,0,16
"G1100010001301601","G1100010001301",47,4,0,1,1,1,54
"G1100010001301602","G1100010001301",30,8,0,3,3,0,44
"G1100010001301603","G1100010001301",34,3,0,2,2,0,41
"G1100010001301604","G1100010001301",28,16,0,1,1,0,46
"G1100010001301605","G1100010001301",35,2,0,0,0,8,45
"G1100010001301606","G1100010001301",34,0,0,3,3,2,42
"G1100010001301701","G1100010001301",49,0,0,0,0,2,51
"G1100010001301702","G1100010001301",542,63,0,26,26,28,685
"G1100010001301703","G1100010001301",202,9,0,8,8,18,245
"G1100010001301704","G1100010001301",22,0,0,2,2,1,27
"G1100010001301706","G1100010001301",7,2,0,0,0,0,9
"G1100010001301707","G1100010001301",6,0,0,0,0,0,6
"G1100010001301708","G1100010001301",385,25,3,20,20,26,479
"G1100010001301720","G1100010001301",67,0,0,0,0,0,67
"G1100010001301721","G1100010001301",50,13,0,3,3,0,69
"G1100010001302101","G1100010001302",78,0,0,2,2,2,84
"G1100010001302102","G1100010001302",81,11,0,3,3,10,108
"G1100010001302103","G1100010001302",2,0,0,0,0,0,2
"G1100010001302109","G1100010001302",16,0,0,2,2,3,23
"G1100010001302110","G1100010001302",3,0,0,0,0,0,3
"G1100010001302201","G1100010001302",1836,132,4,79,79,164,2294
"G1100010001302202","G1100010001302",0,0,0,0,0,0,0
"G1100010001302203","G1100010001302",6,0,0,0,0,2,8
"G1100010001302204","G1100010001302",9,1,0,1,1,0,12
"G1100010001302205","G1100010001302",164,5,0,8,8,2,187
"G1100010001302206","G1100010001302",410,35,0,49,49,76,619
"G1100010001302301","G1100010001302",204,8,0,9,9,23,253
"G1100010001302304","G1100010001302",316,53,1,31,31,40,472
"G1100010001302307","G1100010001302",26,5,0,2,2,3,38
"G1100010001302308","G1100010001302",55,6,0,2,2,1,66
"G1100010001302309","G1100010001302",1632,163,6,83,83,93,2060
"G1100010001401301","G1100010001401",27,2,0,5,5,1,40
"G1100010001401302","G1100010001401",83,2,0,4,4,2,95
"G1100010001401303","G1100010001401",52,0,0,1,1,1,55
"G1100010001401304","G1100010001401",34,1,0,4,4,0,43
"G1100010001401305","G1100010001401",84,0,0,1,1,3,89
"G1100010001401306","G1100010001401",15,2,0,0,0,0,17
"G1100010001401307","G1100010001401",45,3,0,3,3,0,54
"G1100010001401308","G1100010001401",36,0,0,0,0,0,36
"G1100010001401309","G1100010001401",85,3,0,5,5,1,99
"G1100010001401501","G1100010001401",62,1,0,0,0,0,63
"G1100010001401502","G1100010001401",25,0,0,0,0,1,26
"G1100010001401503","G1100010001401",69,1,0,0,0,2,72
"G1100010001401504","G1100010001401",291,34,1,17,17,47,407
"G1100010001401505","G1100010001401",37,2,0,1,1,1,42
"G1100010001401506","G1100010001401",90,5,0,3,3,0,101
"G1100010001401507","G1100010001401",92,3,0,5,5,2,107
"G1100010001401508","G1100010001401",21,4,0,5,5,6,41
"G1100010001401509","G1100010001401",346,65,1,60,60,61,593
"G1100010001401601","G1100010001401",70,0,0,7,7,1,85
"G1100010001401602","G1100010001401",132,6,1,3,3,8,153
"G1100010001401603","G1100010001401",55,2,0,0,0,0,57
"G1100010001401605","G1100010001401",81,8,0,4,4,1,98
"G1100010001401606","G1100010001401",17,0,0,0,0,1,18
"G1100010001401607","G1100010001401",99,0,0,2,2,0,103
"G1100010001401608","G1100010001401",32,0,0,0,0,0,32
"G1100010001401609","G1100010001401",82,0,0,3,3,1,89
"G1100010001401610","G1100010001401",41,0,0,2,2,2,47
"G1100010001401611","G1100010001401",52,0,0,0,0,3,55
"G1100010001401701","G1100010001401",50,0,0,2,2,5,59
"G1100010001401702","G1100010001401",12,0,0,0,0,0,12
"G1100010001401703","G1100010001401",63,3,0,1,1,0,68
"G1100010001401704","G1100010001401",75,2,0,1,1,7,86
"G1100010001401705","G1100010001401",66,0,1,1,1,3,72
"G1100010001401706","G1100010001401",87,2,0,7,7,0,103
"G1100010001401707","G1100010001401",99,1,0,1,1,0,102
"G1100010001402101","G1100010001402",74,14,0,5,5,3,101
"G1100010001402102","G1100010001402",4,0,0,0,0,0,4
"G1100010001402103","G1100010001402",25,5,0,0,0,5,35
"G1100010001402104","G1100010001402",58,3,0,0,0,0,61
"G1100010001402105","G1100010001402",52,7,0,1,1,0,61
"G1100010001402106","G1100010001402",20,0,0,1,1,3,25
"G1100010001402107","G1100010001402",34,1,0,3,3,0,41
"G1100010001402108","G1100010001402",31,14,0,2,2,4,53
"G1100010001402201","G1100010001402",313,15,0,7,7,1,343
"G1100010001402202","G1100010001402",91,9,0,4,4,4,112
"G1100010001402203","G1100010001402",21,2,0,0,0,0,23
"G1100010001402204","G1100010001402",58,3,0,1,1,6,69
"G1100010001402205","G1100010001402",31,0,0,0,0,0,31
"G1100010001402301","G1100010001402",10,0,0,0,0,0,10
"G1100010001402302","G1100010001402",76,0,0,2,2,4,84
"G1100010001402303","G1100010001402",69,4,0,3,3,5,84
"G1100010001402304","G1100010001402",38,1,0,0,0,2,41
"G1100010001402305","G1100010001402",90,3,0,0,0,11,104
"G1100010001402306","G1100010001402",61,0,0,0,0,0,61
"G1100010001402307","G1100010001402",64,0,0,7,7,12,90
"G1100010001402308","G1100010001402",97,6,0,6,6,0,115
"G1100010001402401","G1100010001402",53,9,0,13,13,2,90
"G1100010001402402","G1100010001402",36,4,0,1,1,0,42
"G1100010001402403","G1100010001402",36,1,0,1,1,1,40
"G1100010001402404","G1100010001402",136,9,0,33,33,35,246
"G1100010001402405","G1100010001402",44,0,0,0,0,0,44
"G1100010001402406","G1100010001402",63,9,0,1,1,0,74
"G1100010001402407","G1100010001402",76,4,0,4,4,3,91
"G1100010001402408","G1100010001402",167,168,2,5,5,11,358
"G1100010001402409","G1100010001402",58,7,0,0,0,8,73
"G1100010001402410","G1100010001402",98,6,0,1,1,8,114
"G1100010001402411","G1100010001402",125,9,0,3,3,23,163
"G1100010001402412","G1100010001402",80,0,0,1,1,0,82
"G11000100015104","G11000100015",57,27,0,1,1,2,88
"G11000100015106","G11000100015",12,9,0,0,0,0,21
"G11000100015107","G11000100015",39,16,0,0,0,3,58
"G11000100015108","G11000100015",35,22,0,4,4,0,65
"G11000100015109","G11000100015",14,41,0,6,6,0,67
"G11000100015110","G11000100015",21,28,0,0,0,7,56
"G11000100015111","G11000100015",33,22,0,1,1,1,58
"G11000100015112","G11000100015",38,17,0,4,4,9,72
"G11000100015113","G11000100015",116,18,0,4,4,10,152
"G11000100015114","G11000100015",27,37,0,0,0,0,64
"G11000100015115","G11000100015",54,11,0,2,2,1,70
"G11000100015203","G11000100015",14,33,0,3,3,7,60
"G11000100015204","G11000100015",34,5,2,2,2,2,47
"G11000100015205","G11000100015",33,14,0,4,4,0,55
"G11000100015206","G11000100015",37,5,0,2,2,1,47
"G11000100015207","G11000100015",71,6,1,5,5,2,90
"G11000100015208","G11000100015",76,2,1,1,1,2,83
"G11000100015209","G11000100015",116,37,0,0,0,1,154
"G11000100015210","G11000100015",52,9,0,0,0,0,61
"G11000100015211","G11000100015",13,0,0,0,0,2,15
"G11000100015301","G11000100015",62,2,0,1,1,4,70
"G11000100015302","G11000100015",89,0,0,0,0,0,89
"G11000100015303","G11000100015",2,7,0,0,0,0,9
"G11000100015304","G11000100015",302,1,0,0,0,1,304
"G11000100015306","G11000100015",103,0,0,0,0,1,104
"G11000100015307","G11000100015",70,0,0,0,0,2,72
"G11000100015308","G11000100015",79,7,0,0,0,0,86
"G11000100015309","G11000100015",78,5,0,0,0,2,85
"G11000100015310","G11000100015",103,6,0,0,0,7,116
"G11000100015401","G11000100015",45,1,0,2,2,1,51
"G11000100015402","G11000100015",91,7,0,2,2,0,102
"G11000100015403","G11000100015",111,1,0,1,1,2,116
"G11000100015404","G11000100015",133,0,0,1,1,6,141
"G11000100015405","G11000100015",53,0,0,0,0,0,53
"G11000100015406","G11000100015",44,0,0,1,1,6,52
"G11000100015407","G11000100015",91,1,0,0,0,1,93
"G11000100015408","G11000100015",69,0,0,0,0,0,69
"G11000100015409","G11000100015",291,106,1,13,13,16,440
"G11000100015410","G11000100015",10,1,0,0,0,0,11
"G11000100015411","G11000100015",106,9,0,6,6,0,127
"G11000100015412","G11000100015",107,0,0,1,1,7,116
"G11000100015413","G11000100015",67,2,0,0,0,1,70
"G11000100015416","G11000100015",27,0,0,0,0,1,28
"G11000100015501","G11000100015",69,8,0,3,3,0,83
"G11000100015502","G11000100015",40,2,1,0,0,0,43
"G11000100015503","G11000100015",82,5,0,0,0,0,87
"G11000100015505","G11000100015",248,7,0,9,9,6,279
"G11000100015507","G11000100015",48,0,0,0,0,1,49
"G11000100015508","G11000100015",43,8,1,4,4,1,61
"G11000100015509","G11000100015",68,12,0,2,2,4,88
"G11000100015510","G11000100015",50,2,0,7,7,1,67
"G11000100015511","G11000100015",64,3,0,0,0,1,68
"G11000100015512","G11000100015",95,0,0,1,1,0,97
"G11000100015513","G11000100015",95,3,0,0,0,0,98
"G11000100015601","G11000100015",102,2,1,3,3,1,112
"G11000100015602","G11000100015",85,10,0,1,1,2,99
"G11000100015603","G11000100015",4,0,0,0,0,0,4
"G11000100015604","G11000100015",45,0,0,0,0,0,45
"G11000100015605","G11000100015",41,2,0,0,0,3,46
"G11000100015606","G11000100015",39,1,0,0,0,0,40
"G11000100015607","G11000100015",26,0,0,0,0,0,26
"G11000100015608","G11000100015",82,1,0,5,5,1,94
"G11000100015609","G11000100015",41,0,0,0,0,0,41
"G11000100015610","G11000100015",64,0,1,1,1,3,70
"G11000100015611","G11000100015",65,5,0,2,2,2,76
"G11000100015612","G11000100015",74,1,0,3,3,3,84
"G11000100015613","G11000100015",66,6,0,6,6,0,84
"G11000100015614","G11000100015",33,3,0,4,4,3,47
"G11000100016103","G11000100016",8,45,0,0,0,0,53
"G11000100016104","G11000100016",15,38,0,1,1,0,55
"G11000100016105","G11000100016",12,79,0,0,0,0,91
"G11000100016109","G11000100016",15,69,2,0,0,1,87
"G11000100016110","G11000100016",15,48,0,0,0,6,69
"G11000100016111","G11000100016",8,30,0,0,0,1,39
"G11000100016112","G11000100016",4,23,0,0,0,1,28
"G11000100016114","G11000100016",5,42,0,3,3,0,53
"G11000100016115","G11000100016",13,18,0,1,1,0,33
"G11000100016118","G11000100016",2,39,0,0,0,0,41
"G11000100016119","G11000100016",27,51,1,1,1,5,86
"G11000100016120","G11000100016",12,60,0,0,0,2,74
"G11000100016121","G11000100016",11,51,0,3,3,0,68
"G11000100016122","G11000100016",12,46,0,0,0,0,58
"G11000100016123","G11000100016",5,25,0,0,0,0,30
"G11000100016124","G11000100016",13,51,0,0,0,0,64
"G11000100016125","G11000100016",13,21,0,1,1,0,36
"G11000100016126","G11000100016",6,21,1,0,0,1,29
"G11000100016127","G11000100016",16,44,0,0,0,3,63
"G11000100016128","G11000100016",11,38,0,0,0,0,49
"G11000100016129","G11000100016",13,21,0,0,0,0,34
"G11000100016130","G11000100016",4,13,0,0,0,0,17
"G11000100016201","G11000100016",5,42,0,4,4,1,56
"G11000100016202","G11000100016",19,55,0,0,0,0,74
"G11000100016203","G11000100016",27,28,0,0,0,0,55
"G11000100016205","G11000100016",9,26,0,1,1,0,37
"G11000100016206","G11000100016",25,28,0,1,1,0,55
"G11000100016207","G11000100016",22,177,1,2,2,13,217
"G11000100016208","G11000100016",8,73,0,6,6,0,93
"G11000100016209","G11000100016",20,26,0,4,4,1,55
"G11000100016210","G11000100016",8,34,0,0,0,0,42
"G11000100016211","G11000100016",29,8,0,0,0,2,39
"G11000100016212","G11000100016",15,50,0,0,0,2,67
"G11000100016301","G11000100016",4,2,0,0,0,0,6
"G11000100016302","G11000100016",6,22,0,0,0,0,28
"G11000100016303","G11000100016",29,30,0,0,0,4,63
"G11000100016304","G11000100016",0,1,0,0,0,0,1
"G11000100016305","G11000100016",34,63,0,0,0,0,97
"G11000100016306","G11000100016",8,49,0,0,0,1,58
"G11000100016307","G11000100016",16,37,0,1,1,1,56
"G11000100016308","G11000100016",24,17,0,0,0,0,41
"G11000100016309","G11000100016",23,40,0,0,0,1,64
"G11000100016310","G11000100016",19,28,0,2,2,0,51
"G11000100016311","G11000100016",9,36,0,2,2,0,49
"G11000100016312","G11000100016",14,68,0,0,0,0,82
"G11000100016313","G11000100016",16,54,0,4,4,2,80
"G11000100016314","G11000100016",34,35,0,0,0,0,69
"G11000100016315","G11000100016",24,32,0,0,0,1,57
"G11000100016316","G11000100016",43,98,0,0,0,3,144
"G11000100016401","G11000100016",31,19,0,0,0,1,51
"G11000100016402","G11000100016",16,47,0,1,1,0,65
"G11000100016403","G11000100016",15,16,1,3,3,0,38
"G11000100016406","G11000100016",5,26,0,0,0,0,31
"G11000100016407","G11000100016",14,41,0,0,0,0,55
"G11000100016408","G11000100016",10,52,0,1,1,0,64
"G11000100016409","G11000100016",25,66,0,0,0,1,92
"G11000100016410","G11000100016",12,30,0,1,1,0,44
"G11000100016411","G11000100016",36,50,0,0,0,0,86
"G11000100016412","G11000100016",16,67,0,1,1,7,92
"G11000100016413","G11000100016",17,31,0,0,0,0,48
"G11000100016501","G11000100016",4,0,0,0,0,0,4
"G11000100016502","G11000100016",16,38,0,1,1,0,56
"G11000100016503","G11000100016",8,105,0,0,0,2,115
"G11000100016504","G11000100016",0,36,1,0,0,0,37
"G11000100016505","G11000100016",8,51,0,0,0,0,59
"G11000100016506","G11000100016",6,50,1,0,0,0,57
"G11000100016507","G11000100016",4,70,0,0,0,0,74
"G11000100016508","G11000100016",11,76,0,0,0,10,97
"G11000100016509","G11000100016",9,41,0,2,2,0,54
"G11000100016510","G11000100016",0,28,0,0,0,0,28
"G11000100016511","G11000100016",0,33,0,1,1,0,35
"G11000100016601","G11000100016",17,14,0,1,1,0,33
"G11000100016602","G11000100016",16,35,0,0,0,0,51
"G11000100016603","G11000100016",39,20,0,0,0,2,61
"G11000100016605","G11000100016",13,20,0,0,0,1,34
"G11000100016606","G11000100016",17,41,0,0,0,0,58
"G11000100016609","G11000100016",14,13,0,0,0,0,27
"G11000100016610","G11000100016",17,17,0,7,7,0,48
"G11000100016611","G11000100016",18,20,0,1,1,0,40
"G1100010001701102","G1100010001701",19,160,0,8,8,10,205
"G1100010001701103","G1100010001701",4,71,0,0,0,8,83
"G1100010001701104","G1100010001701",2,93,0,0,0,0,95
"G1100010001701105","G1100010001701",6,105,0,6,6,14,137
"G1100010001701107","G1100010001701",0,68,0,0,0,0,68
"G1100010001701108","G1100010001701",2,38,0,0,0,0,40
"G1100010001701109","G1100010001701",0,40,0,0,0,0,40
"G1100010001701110","G1100010001701",2,57,0,0,0,0,59
"G1100010001701111","G1100010001701",1,66,1,0,0,0,68
"G1100010001701112","G1100010001701",23,176,4,1,1,13,218
"G1100010001701114","G1100010001701",5,105,0,4,4,1,119
"G1100010001701115","G1100010001701",5,70,0,3,3,23,104
"G1100010001701501","G1100010001701",17,56,0,0,0,0,73
"G1100010001701502","G1100010001701",38,63,0,0,0,8,109
"G1100010001701503","G1100010001701",6,50,0,0,0,0,56
"G1100010001701504","G1100010001701",12,55,0,0,0,0,67
"G1100010001701505","G1100010001701",7,134,0,0,0,0,141
"G1100010001701506","G1100010001701",2,47,0,0,0,0,49
"G1100010001701507","G1100010001701",17,40,0,0,0,0,57
"G1100010001701508","G1100010001701",4,28,0,0,0,0,32
"G1100010001701509","G1100010001701",0,14,0,0,0,0,14
"G1100010001701510","G1100010001701",0,12,0,0,0,0,12
"G1100010001701511","G1100010001701",15,38,0,0,0,3,56
"G1100010001701512","G1100010001701",4,87,0,0,0,0,91
"G1100010001701513","G1100010001701",27,309,2,29,29,11,407
"G1100010001701601","G1100010001701",10,35,0,9,9,1,64
"G1100010001701602","G1100010001701",19,19,0,2,2,2,44
"G1100010001701603","G1100010001701",31,175,0,2,2,20,230
"G1100010001701604","G1100010001701",13,121,0,0,0,0,134
"G1100010001701605","G1100010001701",26,141,0,2,2,5,176
"G1100010001702201","G1100010001702",8,192,0,3,3,20,226
"G1100010001702202","G1100010001702",8,26,0,0,0,17,51
"G1100010001702204","G1100010001702",13,22,0,0,0,0,35
"G1100010001702205","G1100010001702",7,15,0,2,2,0,26
"G1100010001702208","G1100010001702",8,19,1,0,0,0,28
"G1100010001702210","G1100010001702",11,37,0,0,0,3,51
"G1100010001702211","G1100010001702",14,32,0,1,1,0,48
"G1100010001702212","G1100010001702",20,29,0,0,0,1,50
"G1100010001702213","G1100010001702",26,49,0,0,0,4,79
"G1100010001702301","G1100010001702",8,43,7,0,0,1,59
"G1100010001702302","G1100010001702",5,23,0,0,0,4,32
"G1100010001702303","G1100010001702",10,43,0,0,0,1,54
"G1100010001702304","G1100010001702",13,18,1,0,0,0,32
"G1100010001702305","G1100010001702",13,302,1,1,1,1,319
"G1100010001702306","G1100010001702",7,197,0,0,0,2,206
"G1100010001702308","G1100010001702",4,101,0,0,0,0,105
"G1100010001702401","G1100010001702",6,4,0,6,6,0,22
"G1100010001702402","G1100010001702",4,19,1,0,0,4,28
"G1100010001702403","G1100010001702",5,0,0,0,0,0,5
"G1100010001702404","G1100010001702",15,9,0,0,0,0,24
"G1100010001702405","G1100010001702",34,95,0,2,2,2,135
"G1100010001702408","G1100010001702",1,18,0,0,0,1,20
"G1100010001702409","G1100010001702",26,50,0,7,7,11,101
"G1100010001702410","G1100010001702",24,39,0,0,0,0,63
"G1100010001702411","G1100010001702",28,70,1,5,5,7,116
"G1100010001702413","G1100010001702",2,57,0,0,0,0,59
"G1100010001702415","G1100010001702",11,51,2,0,0,0,64
"G1100010001702501","G1100010001702",2,11,0,0,0,0,13
"G1100010001702502","G1100010001702",6,3,0,0,0,0,9
"G1100010001702503","G1100010001702",12,2,0,0,0,3,17
"G1100010001702504","G1100010001702",22,35,0,0,0,1,58
"G1100010001702601","G1100010001702",19,7,0,0,0,0,26
"G1100010001702602","G1100010001702",26,27,0,1,1,0,55
"G1100010001702603","G1100010001702",22,74,0,2,2,4,104
"G1100010001702604","G1100010001702",18,22,0,2,2,1,45
"G1100010001702605","G1100010001702",17,48,0,0,0,0,65
"G1100010001702606","G1100010001702",1,61,0,0,0,0,62
"G1100010001702607","G1100010001702",8,53,0,0,0,0,61
"G1100010001702608","G1100010001702",5,40,0,0,0,0,45
"G1100010001702609","G1100010001702",0,35,0,0,0,0,35
"G1100010001801105","G1100010001801",358,313,6,15,15,71,778
"G1100010001803501","G1100010001803",13,97,0,1,1,4,116
"G1100010001803502","G1100010001803",29,113,0,0,0,3,145
"G1100010001803503","G1100010001803",21,120,0,1,1,12,155
"G1100010001803504","G1100010001803",9,97,0,0,0,20,126
"G1100010001803505","G1100010001803",7,41,0,1,1,0,50
"G1100010001803507","G1100010001803",2,81,0,4,4,4,95
"G1100010001803508","G1100010001803",9,244,0,3,3,37,296
"G1100010001803509","G1100010001803",11,39,0,2,2,2,56
"G1100010001803601","G1100010001803",6,327,2,0,0,17,352
"G1100010001803602","G1100010001803",0,109,0,0,0,0,109
"G1100010001803603","G1100010001803",76,247,2,1,1,2,329
"G1100010001803604","G1100010001803",18,96,0,2,2,4,122
"G1100010001803605","G1100010001803",8,385,2,3,3,56,457
"G1100010001803606","G1100010001803",2,322,3,0,0,24,351
"G1100010001804101","G1100010001804",6,476,4,2,2,86,576
"G1100010001804102","G1100010001804",2,84,3,0,0,1,90
"G1100010001804103","G1100010001804",3,54,0,0,0,0,57
"G1100010001804104","G1100010001804",1,55,0,0,0,0,56
"G1100010001804105","G1100010001804",0,26,0,0,0,0,26
"G1100010001804106","G1100010001804",0,28,0,0,0,0,28
"G1100010001804201","G1100010001804",0,94,0,0,0,28,122
"G1100010001804202","G1100010001804",2,18,0,0,0,21,41
"G1100010001804203","G1100010001804",0,3,0,0,0,0,3
"G1100010001804204","G1100010001804",3,57,1,2,2,0,65
"G1100010001804205","G1100010001804",3,0,0,0,0,0,3
"G1100010001804207","G1100010001804",0,143,0,0,0,6,149
"G1100010001804208","G1100010001804",0,5,0,0,0,0,5
"G1100010001804301","G1100010001804",9,164,3,0,0,0,176
"G1100010001804302","G1100010001804",9,434,1,0,0,12,456
"G1100010001804303","G1100010001804",1,75,0,0,0,38,114
"G1100010001804304","G1100010001804",10,379,0,0,0,149,538
"G1100010001804305","G1100010001804",2,36,0,0,0,11,49
"G1100010001804306","G1100010001804",18,210,2,1,1,6,238
"G1100010001804307","G1100010001804",5,292,0,2,2,64,365
"G1100010001804308","G1100010001804",2,42,0,0,0,8,52
"G1100010001804401","G1100010001804",4,112,0,1,1,1,119
"G1100010001804402","G1100010001804",6,145,1,0,0,14,166
"G1100010001804403","G1100010001804",13,128,0,0,0,7,148
"G1100010001804404","G1100010001804",2,218,0,1,1,4,226
"G1100010001804405","G1100010001804",0,17,0,0,0,0,17
"G1100010001804406","G1100010001804",0,20,0,0,0,0,20
"G1100010001804407","G1100010001804",3,17,0,0,0,0,20
"G1100010001804408","G1100010001804",2,284,6,6,6,6,310
"G1100010001901501","G1100010001901",3,90,0,0,0,2,95
"G1100010001901502","G1100010001901",0,21,0,0,0,6,27
"G1100010001901503","G1100010001901",0,44,0,0,0,0,44
"G1100010001901504","G1100010001901",0,15,0,0,0,0,15
"G1100010001901506","G1100010001901",1,218,0,0,0,8,227
"G1100010001901507","G1100010001901",1,7,0,0,0,5,13
"G1100010001901508","G1100010001901",3,70,0,4,4,0,81
"G1100010001901509","G1100010001901",5,51,0,0,0,1,57
"G1100010001901510","G1100010001901",2,69,0,0,0,0,71
"G1100010001901511","G1100010001901",2,111,2,1,1,0,117
"G1100010001901512","G1100010001901",3,77,0,0,0,5,85
"G1100010001901513","G1100010001901",0,39,0,0,0,0,39
"G1100010001901514","G1100010001901",2,151,0,0,0,2,155
"G1100010001901601","G1100010001901",1,124,0,0,0,0,125
"G1100010001901602","G1100010001901",2,111,0,0,0,3,116
"G1100010001901603","G1100010001901",3,123,0,2,2,5,135
"G1100010001901604","G1100010001901",0,37,0,0,0,1,38
"G1100010001901606","G1100010001901",2,56,0,0,0,1,59
"G1100010001901607","G1100010001901",1,86,1,0,0,0,88
"G1100010001901608","G1100010001901",1,64,0,0,0,8,73
"G1100010001901609","G1100010001901",0,56,0,0,0,0,56
"G1100010001901610","G1100010001901",1,77,0,0,0,0,78
"G1100010001901611","G1100010001901",5,97,0,1,1,3,107
"G1100010001901612","G1100010001901",2,128,0,0,0,17,147
"G1100010001901701","G1100010001901",1,161,0,0,0,0,162
"G1100010001901702","G1100010001901",0,190,1,3,3,7,204
"G1100010001901703","G1100010001901",0,91,1,0,0,4,96
"G1100010001901704","G1100010001901",1,79,0,0,0,0,80
"G1100010001901705","G1100010001901",1,37,0,0,0,0,38
"G1100010001901706","G1100010001901",0,17,0,1,1,6,25
"G1100010001901707","G1100010001901",6,86,0,1,1,3,97
"G1100010001901708","G1100010001901",0,110,0,0,0,4,114
"G1100010001901709","G1100010001901",0,100,0,0,0,4,104
"G1100010001901710","G1100010001901",0,88,4,0,0,7,99
"G1100010001901711","G1100010001901",1,157,0,0,0,6,164
"G1100010001901712","G1100010001901",3,134,1,0,0,5,143
"G1100010001901713","G1100010001901",3,88,0,0,0,0,91
"G1100010001901801","G1100010001901",4,86,0,3,3,0,96
"G1100010001901802","G1100010001901",0,40,0,0,0,0,40
"G1100010001901803","G1100010001901",0,80,0,0,0,0,80
"G1100010001901804","G1100010001901",2,103,0,0,0,8,113
"G1100010001901805","G1100010001901",2,63,0,0,0,0,65
"G1100010001901806","G1100010001901",7,78,0,1,1,0,87
"G1100010001901807","G1100010001901",1,75,0,0,0,5,81
"G1100010001901808","G1100010001901",1,9,0,0,0,3,13
"G1100010001901811","G1100010001901",7,54,0,0,0,0,61
"G1100010001901812","G1100010001901",4,61,0,0,0,0,65
"G1100010001901813","G1100010001901",2,106,0,0,0,2,110
"G1100010001901814","G1100010001901",19,54,1,0,0,0,74
"G1100010001901815","G1100010001901",6,40,0,1,1,2,50
"G1100010001902103","G1100010001902",12,97,0,3,3,0,115
"G1100010001902104","G1100010001902",1,65,0,0,0,0,66
"G1100010001902105","G1100010001902",8,43,0,0,0,0,51
"G1100010001902106","G1100010001902",7,63,0,0,0,7,77
"G1100010001902107","G1100010001902",0,6,0,0,0,0,6
"G1100010001902201","G1100010001902",0,22,0,0,0,4,26
"G1100010001902202","G1100010001902",3,81,0,1,1,2,88
"G1100010001902203","G1100010001902",3,75,0,0,0,0,78
"G1100010001902204","G1100010001902",2,89,0,0,0,0,91
"G1100010001902205","G1100010001902",15,37,0,2,2,2,58
"G1100010001902206","G1100010001902",2,26,0,0,0,3,31
"G1100010001902207","G1100010001902",3,65,1,0,0,0,69
"G1100010001902208","G1100010001902",0,5,0,0,0,0,5
"G1100010001902211","G1100010001902",11,77,2,0,0,0,90
"G1100010001902212","G1100010001902",2,94,0,0,0,0,96
"G1100010001902301","G1100010001902",3,105,0,0,0,3,111
"G1100010001902302","G1100010001902",6,85,0,0,0,0,91
"G1100010001902303","G1100010001902",2,91,2,0,0,1,96
"G1100010001902304","G1100010001902",2,48,0,0,0,0,50
"G1100010001902305","G1100010001902",2,10,0,0,0,0,12
"G1100010001902306","G1100010001902",1,25,0,0,0,0,26
"G1100010001902307","G1100010001902",1,89,3,0,0,2,95
"G1100010001902308","G1100010001902",1,83,0,0,0,0,84
"G1100010001902309","G1100010001902",8,72,0,0,0,0,80
"G1100010001902310","G1100010001902",3,73,0,0,0,3,79
"G1100010001902311","G1100010001902",3,88,0,0,0,0,91
"G1100010001902312","G1100010001902",1,81,0,1,1,1,85
"G1100010001902401","G1100010001902",3,118,0,0,0,1,122
"G1100010001902402","G1100010001902",5,53,0,0,0,0,58
"G1100010001902403","G1100010001902",5,62,0,0,0,1,68
"G1100010001902406","G1100010001902",3,100,0,0,0,0,103
"G1100010001902407","G1100010001902",0,95,0,0,0,0,95
"G1100010001902408","G1100010001902",2,99,0,0,0,0,101
"G1100010001902409","G1100010001902",3,113,0,0,0,1,117
"G1100010002001101","G1100010002001",0,17,3,0,0,46,66
"G1100010002001102","G1100010002001",25,528,2,16,16,56,643
"G1100010002001104","G1100010002001",12,199,5,4,4,48,272
"G1100010002001106","G1100010002001",17,91,2,0,0,7,117
"G1100010002001110","G1100010002001",3,86,0,4,4,6,103
"G1100010002001111","G1100010002001",1,17,0,0,0,2,20
"G1100010002001701","G1100010002001",20,88,0,0,0,5,113
"G1100010002001702","G1100010002001",30,6,0,0,0,1,37
"G1100010002001704","G1100010002001",1,20,0,0,0,0,21
"G1100010002001705","G1100010002001",38,34,0,0,0,0,72
"G1100010002001706","G1100010002001",9,16,0,0,0,0,25
"G1100010002001707","G1100010002001",124,140,0,3,3,7,277
"G1100010002001708","G1100010002001",42,140,0,2,2,31,217
"G1100010002001710","G1100010002001",14,72,0,0,0,8,94
"G1100010002001715","G1100010002001",24,45,0,5,5,9,88
"G1100010002001716","G1100010002001",35,56,0,4,4,1,100
"G1100010002001719","G1100010002001",44,134,1,7,7,2,195
"G1100010002002201","G1100010002002",1,165,0,0,0,5,171
"G1100010002002202","G1100010002002",18,171,0,0,0,1,190
"G1100010002002205","G1100010002002",26,347,1,1,1,30,406
"G1100010002002206","G1100010002002",3,125,0,0,0,29,157
"G1100010002002207","G1100010002002",12,151,0,0,0,3,166
"G1100010002002208","G1100010002002",4,161,0,10,10,6,191
"G1100010002002301","G1100010002002",8,101,1,0,0,14,124
"G1100010002002302","G1100010002002",15,110,0,0,0,0,125
"G1100010002002303","G1100010002002",7,144,2,0,0,10,163
"G1100010002002304","G1100010002002",5,155,0,1,1,0,162
"G1100010002002305","G1100010002002",4,95,0,0,0,5,104
"G1100010002002306","G1100010002002",19,164,0,1,1,0,185
"G1100010002002401","G1100010002002",19,89,0,0,0,0,108
"G1100010002002402","G1100010002002",11,75,0,0,0,8,94
"G1100010002002403","G1100010002002",15,64,0,0,0,8,87
"G1100010002002404","G1100010002002",1,56,0,0,0,0,57
"G1100010002002405","G1100010002002",4,40,0,0,0,0,44
"G1100010002002407","G1100010002002",16,58,0,0,0,0,74
"G1100010002002408","G1100010002002",15,134,0,4,4,20,177
"G1100010002002502","G1100010002002",19,111,1,1,1,2,135
"G1100010002002503","G1100010002002",2,61,1,2,2,1,69
"G1100010002002504","G1100010002002",19,120,1,0,0,2,142
"G1100010002002505","G1100010002002",9,125,1,0,0,0,135
"G1100010002002506","G1100010002002",10,125,0,2,2,0,139
"G1100010002002507","G1100010002002",0,2,0,0,0,0,2
"G1100010002002508","G1100010002002",0,15,0,0,0,0,15
"G1100010002002509","G1100010002002",2,16,0,0,0,8,26
"G1100010002002510","G1100010002002",5,105,0,0,0,17,127
"G1100010002002601","G1100010002002",10,2,0,1,1,0,14
"G1100010002002602","G1100010002002",2,17,0,0,0,0,19
"G1100010002002603","G1100010002002",8,28,0,0,0,1,37
"G1100010002002604","G1100010002002",1,13,0,0,0,0,14
"G1100010002002605","G1100010002002",7,27,0,1,1,2,38
"G1100010002002606","G1100010002002",6,9,0,0,0,2,17
"G1100010002002607","G1100010002002",20,4,2,0,0,0,26
"G1100010002002608","G1100010002002",15,17,0,0,0,0,32
"G1100010002002609","G1100010002002",7,40,0,9,9,3,68
"G1100010002002613","G1100010002002",7,35,0,0,0,1,43
"G1100010002002620","G1100010002002",19,52,0,1,1,0,73
"G1100010002002621","G1100010002002",16,40,0,0,0,1,57
"G1100010002101101","G1100010002101",0,5,0,0,0,0,5
"G1100010002101102","G1100010002101",0,109,0,0,0,1,110
"G1100010002101103","G1100010002101",3,136,3,0,0,0,142
"G1100010002101104","G1100010002101",0,5,0,0,0,0,5
"G1100010002101105","G1100010002101",1,125,0,0,0,4,130
"G1100010002101108","G1100010002101",2,255,1,0,0,3,261
"G1100010002101109","G1100010002101",2,136,0,0,0,5,143
"G1100010002101110","G1100010002101",4,337,0,0,0,7,348
"G1100010002101111","G1100010002101",4,84,1,0,0,7,96
"G1100010002101112","G1100010002101",3,146,2,0,0,17,168
"G1100010002101201","G1100010002101",6,142,0,1,1,17,167
"G1100010002101206","G1100010002101",0,279,0,0,0,22,301
"G1100010002101207","G1100010002101",6,289,0,2,2,6,305
"G1100010002101209","G1100010002101",2,197,1,0,0,7,207
"G1100010002101301","G1100010002101",1,253,0,0,0,5,259
"G1100010002101302","G1100010002101",5,195,0,2,2,0,204
"G1100010002101303","G1100010002101",0,171,4,0,0,1,176
"G1100010002101304","G1100010002101",1,225,0,0,0,7,233
"G1100010002101305","G1100010002101",4,212,0,1,1,5,223
"G1100010002101306","G1100010002101",1,172,0,0,0,0,173
"G1100010002101401","G1100010002101",1,120,0,0,0,3,124
"G1100010002101403","G1100010002101",0,109,0,0,0,17,126
"G1100010002101404","G1100010002101",0,125,0,0,0,18,143
"G1100010002101405","G1100010002101",0,26,0,0,0,0,26
"G1100010002101407","G1100010002101",0,265,0,0,0,17,282
"G1100010002101408","G1100010002101",1,53,0,0,0,0,54
"G1100010002101409","G1100010002101",0,97,0,5,5,5,112
"G1100010002101501","G1100010002101",3,26,0,1,1,0,31
"G1100010002101502","G1100010002101",0,229,1,11,11,4,256
"G1100010002101503","G1100010002101",2,248,0,1,1,8,260
"G1100010002101504","G1100010002101",4,135,0,4,4,0,147
"G1100010002101505","G1100010002101",0,0,0,0,0,0,0
"G1100010002101506","G1100010002101",0,79,0,6,6,3,94
"G1100010002102101","G1100010002102",2,74,0,0,0,1,77
"G1100010002102102","G1100010002102",2,78,0,0,0,0,80
"G1100010002102103","G1100010002102",0,67,0,0,0,5,72
"G1100010002102104","G1100010002102",1,68,0,0,0,0,69
"G1100010002102105","G1100010002102",1,100,0,0,0,0,101
"G1100010002102106","G1100010002102",3,107,0,0,0,1,111
"G1100010002102201","G1100010002102",4,184,0,0,0,0,188
"G1100010002102202","G1100010002102",0,166,0,0,0,0,166
"G1100010002102204","G1100010002102",0,20,0,0,0,0,20
"G1100010002102205","G1100010002102",4,61,0,0,0,6,71
"G1100010002102206","G1100010002102",7,169,0,0,0,1,177
"G1100010002102207","G1100010002102",2,49,0,0,0,17,68
"G1100010002102208","G1100010002102",0,7,0,0,0,0,7
"G1100010002102209","G1100010002102",10,182,0,0,0,22,214
"G1100010002102301","G1100010002102",1,122,8,0,0,0,131
"G1100010002102302","G1100010002102",6,163,1,0,0,0,170
"G1100010002102303","G1100010002102",5,141,0,1,1,2,150
"G1100010002102304","G1100010002102",0,32,0,0,0,0,32
"G1100010002102305","G1100010002102",0,68,1,2,2,3,76
"G1100010002102306","G1100010002102",0,234,0,0,0,6,240
"G1100010002102401","G1100010002102",1,57,0,0,0,0,58
"G1100010002102402","G1100010002102",0,20,0,0,0,0,20
"G1100010002102403","G1100010002102",0,69,0,0,0,8,77
"G1100010002102404","G1100010002102",0,39,0,0,0,0,39
"G1100010002102405","G1100010002102",3,160,0,3,3,0,169
"G1100010002102406","G1100010002102",2,186,0,0,0,0,188
"G1100010002102409","G1100010002102",0,244,1,6,6,17,274
"G1100010002102501","G1100010002102",2,103,1,0,0,0,106
"G1100010002102503","G1100010002102",2,148,0,0,0,0,150
"G1100010002102504","G1100010002102",0,186,0,0,0,2,188
"G1100010002102505","G1100010002102",3,32,0,0,0,0,35
"G1100010002102506","G1100010002102",1,145,0,0,0,3,149
"G1100010002102601","G1100010002102",0,3,0,0,0,0,3
"G1100010002102602","G1100010002102",0,94,0,1,1,0,96
"G1100010002102603","G1100010002102",1,193,0,0,0,8,202
"G1100010002102604","G1100010002102",3,201,0,3,3,7,217
"G1100010002102605","G1100010002102",0,108,0,0,0,0,108
"G1100010002102606","G1100010002102",0,104,0,2,2,0,108
"G1100010002102607","G1100010002102",3,19,0,0,0,0,22
"G1100010002102608","G1100010002102",2,150,1,5,5,25,188
"G1100010002102701","G1100010002102",0,123,0,0,0,0,123
"G1100010002102702","G1100010002102",1,34,0,0,0,0,35
"G1100010002102703","G1100010002102",1,15,0,0,0,0,16
"G1100010002102704","G1100010002102",0,24,0,0,0,0,24
"G1100010002102705","G1100010002102",0,39,0,0,0,0,39
"G1100010002102706","G1100010002102",1,25,0,0,0,0,26
"G1100010002102707","G1100010002102",0,92,1,0,0,0,93
"G1100010002102708","G1100010002102",2,122,0,0,0,9,133
"G1100010002201101","G1100010002201",7,204,0,0,0,12,223
"G1100010002201102","G1100010002201",1,125,0,0,0,0,126
"G1100010002201103","G1100010002201",1,101,1,0,0,8,111
"G1100010002201104","G1100010002201",0,161,0,0,0,1,162
"G1100010002201105","G1100010002201",1,254,0,0,0,7,262
"G1100010002201107","G1100010002201",0,120,0,0,0,20,140
"G1100010002201108","G1100010002201",0,61,0,0,0,0,61
"G1100010002201109","G1100010002201",2,129,0,0,0,0,131
"G1100010002201110","G1100010002201",6,118,1,1,1,17,144
"G1100010002201111","G1100010002201",1,60,3,0,0,4,68
"G1100010002201201","G1100010002201",5,133,0,1,1,7,147
"G1100010002201203","G1100010002201",0,112,0,0,0,19,131
"G1100010002201205","G1100010002201",3,185,0,0,0,0,188
"G1100010002201207","G1100010002201",5,77,0,0,0,8,90
"G1100010002201301","G1100010002201",0,156,0,0,0,6,162
"G1100010002201302","G1100010002201",1,128,0,0,0,0,129
"G1100010002201303","G1100010002201",2,127,0,0,0,0,129
"G1100010002201304","G1100010002201",1,178,1,0,0,10,190
"G1100010002201305","G1100010002201",3,135,0,0,0,0,138
"G1100010002201306","G1100010002201",1,98,0,4,4,4,111
"G1100010002201401","G1100010002201",0,92,0,0,0,1,93
"G1100010002201402","G1100010002201",2,147,0,2,2,7,160
"G1100010002201403","G1100010002201",0,39,0,0,0,0,39
"G1100010002201404","G1100010002201",6,94,0,0,0,15,115
"G1100010002201405","G1100010002201",5,90,3,1,1,8,108
"G1100010002201406","G1100010002201",4,130,0,0,0,25,159
"G1100010002201407","G1100010002201",1,133,0,0,0,4,138
"G1100010002202101","G1100010002202",7,101,0,0,0,0,108
"G1100010002202102","G1100010002202",5,435,0,0,0,7,447
"G1100010002202103","G1100010002202",2,129,0,0,0,0,131
"G1100010002202104","G1100010002202",0,63,0,0,0,1,64
"G1100010002202105","G1100010002202",7,197,0,0,0,7,211
"G1100010002202106","G1100010002202",6,110,0,0,0,11,127
"G1100010002202107","G1100010002202",14,105,0,1,1,1,122
"G1100010002202108","G1100010002202",1,181,0,1,1,32,216
"G1100010002202201","G1100010002202",1,80,0,0,0,0,81
"G1100010002202202","G1100010002202",1,216,0,0,0,7,224
"G1100010002202204","G1100010002202",1,91,6,0,0,3,101
"G1100010002202205","G1100010002202",0,99,0,0,0,1,100
"G1100010002202206","G1100010002202",0,153,0,0,0,10,163
"G1100010002202207","G1100010002202",2,160,0,0,0,0,162
"G1100010002202301","G1100010002202",2,167,0,1,1,3,174
"G1100010002202302","G1100010002202",1,163,1,0,0,2,167
"G1100010002202303","G1100010002202",1,187,0,0,0,20,208
"G1100010002202304","G1100010002202",1,158,0,0,0,8,167
"G1100010002202306","G1100010002202",0,88,0,0,0,3,91
"G1100010002202307","G1100010002202",1,90,0,0,0,6,97
"G1100010002202308","G1100010002202",1,131,2,0,0,4,138
"G1100010002301101","G1100010002301",4,266,0,0,0,2,272
"G1100010002301102","G1100010002301",0,118,0,0,0,0,118
"G1100010002301103","G1100010002301",10,128,0,0,0,0,138
"G1100010002301104","G1100010002301",0,248,0,0,0,1,249
"G1100010002301105","G1100010002301",2,123,0,0,0,12,137
"G1100010002301106","G1100010002301",2,154,0,0,0,0,156
"G1100010002301108","G1100010002301",2,133,0,7,7,4,153
"G1100010002301109","G1100010002301",3,123,0,0,0,0,126
"G1100010002301201","G1100010002301",1,97,0,0,0,1,99
"G1100010002301204","G1100010002301",3,135,0,0,0,2,140
"G1100010002301205","G1100010002301",2,128,0,0,0,8,138
"G1100010002301206","G1100010002301",1,102,0,0,0,4,107
"G1100010002301208","G1100010002301",1,86,0,0,0,0,87
"G1100010002301209","G1100010002301",4,98,2,0,0,5,109
"G1100010002301301","G1100010002301",1,44,0,0,0,4,49
"G1100010002301302","G1100010002301",5,144,0,0,0,11,160
"G1100010002301303","G1100010002301",4,159,0,0,0,1,164
"G1100010002301305","G1100010002301",1,35,0,0,0,0,36
"G1100010002301306","G1100010002301",2,139,0,0,0,12,153
"G1100010002301308","G1100010002301",5,62,0,0,0,4,71
"G1100010002301401","G1100010002301",2,133,0,0,0,0,135
"G1100010002301402","G1100010002301",2,115,0,0,0,0,117
"G1100010002301404","G1100010002301",1,51,0,0,0,0,52
"G1100010002301405","G1100010002301",1,103,0,0,0,0,104
"G1100010002301406","G1100010002301",0,65,0,0,0,2,67
"G1100010002301407","G1100010002301",0,204,0,0,0,7,211
"G1100010002302101","G1100010002302",1760,250,5,6,6,42,2069
"G1100010002302109","G1100010002302",81,151,0,2,2,14,250
"G1100010002302113","G1100010002302",285,615,1,20,20,49,990
"G1100010002302114","G1100010002302",152,255,2,2,2,3,416
"G1100010002302115","G1100010002302",204,449,1,11,11,22,698
"G1100010002302117","G1100010002302",0,33,0,1,1,0,35
"G11000100024101","G11000100024",2,113,0,0,0,4,119
"G11000100024102","G11000100024",4,88,0,0,0,0,92
"G11000100024103","G11000100024",1,90,0,0,0,6,97
"G11000100024104","G11000100024",4,79,0,7,7,14,111
"G11000100024105","G11000100024",2,26,0,0,0,4,32
"G11000100024106","G11000100024",3,114,0,0,0,2,119
"G11000100024107","G11000100024",3,83,0,0,0,7,93
"G11000100024108","G11000100024",0,9,0,0,0,0,9
"G11000100024109","G11000100024",0,2,0,0,0,0,2
"G11000100024110","G11000100024",0,0,0,0,0,0,0
"G11000100024201","G11000100024",9,110,0,0,0,3,122
"G11000100024202","G11000100024",2,70,0,0,0,2,74
"G11000100024206","G11000100024",2,127,0,0,0,0,129
"G11000100024207","G11000100024",2,45,0,0,0,0,47
"G11000100024208","G11000100024",3,68,0,1,1,8,81
"G11000100024210","G11000100024",3,53,0,0,0,1,57
"G11000100024220","G11000100024",0,25,0,0,0,2,27
"G11000100024301","G11000100024",10,94,0,0,0,10,114
"G11000100024302","G11000100024",2,194,0,0,0,16,212
"G11000100024303","G11000100024",0,22,0,0,0,0,22
"G11000100024304","G11000100024",6,101,0,7,7,4,125
"G11000100024305","G11000100024",2,172,0,0,0,7,181
"G11000100024306","G11000100024",2,38,0,0,0,6,46
"G11000100024309","G11000100024",2,97,0,1,1,0,101
"G11000100024401","G11000100024",3,151,0,0,0,12,166
"G11000100024402","G11000100024",4,155,0,0,0,15,174
"G11000100024403","G11000100024",4,30,0,0,0,0,34
"G11000100024404","G11000100024",1,87,0,0,0,2,90
"G11000100024405","G11000100024",1,94,1,0,0,9,105
"G11000100024406","G11000100024",5,74,0,0,0,5,84
"G11000100024408","G11000100024",0,178,0,0,0,13,191
"G11000100024409","G11000100024",0,87,0,0,0,2,89
"G11000100024501","G11000100024",7,216,0,0,0,4,227
"G11000100024502","G11000100024",1,112,0,0,0,16,129
"G11000100024503","G11000100024",7,193,0,3,3,6,212
"G11000100024505","G11000100024",1,44,0,0,0,0,45
"G11000100024506","G11000100024",0,22,0,0,0,5,27
"G11000100024507","G11000100024",9,156,1,0,0,10,176
"G11000100024508","G11000100024",6,120,0,0,0,10,136
"G1100010002501101","G1100010002501",2,48,0,0,0,4,54
"G1100010002501103","G1100010002501",0,0,0,0,0,2,2
"G1100010002501104","G1100010002501",1,160,3,0,0,3,167
"G1100010002501105","G1100010002501",2,96,0,0,0,0,98
"G1100010002501106","G1100010002501",4,256,0,0,0,29,289
"G1100010002501201","G1100010002501",1,104,0,0,0,30,135
"G1100010002501202","G1100010002501",2,73,0,0,0,3,78
"G1100010002501203","G1100010002501",0,2,0,0,0,0,2
"G1100010002501205","G1100010002501",0,6,0,0,0,0,6
"G1100010002501206","G1100010002501",4,62,0,0,0,58,124
"G1100010002501301","G1100010002501",5,55,0,0,0,24,84
"G1100010002501302","G1100010002501",31,171,0,0,0,0,202
"G1100010002501303","G1100010002501",8,82,0,2,2,8,102
"G1100010002501304","G1100010002501",22,131,0,1,1,10,165
"G1100010002501305","G1100010002501",16,71,0,0,0,12,99
"G1100010002501306","G1100010002501",13,71,0,1,1,15,101
"G1100010002501307","G1100010002501",12,117,0,0,0,7,136
"G1100010002501308","G1100010002501",26,54,0,0,0,2,82
"G1100010002501401","G1100010002501",18,105,0,0,0,11,134
"G1100010002501402","G1100010002501",18,75,0,4,4,6,107
"G1100010002501403","G1100010002501",2,10,0,0,0,0,12
"G1100010002501404","G1100010002501",3,9,0,0,0,4,16
"G1100010002501405","G1100010002501",13,71,1,0,0,2,87
"G1100010002501406","G1100010002501",9,89,0,0,0,12,110
"G1100010002502101","G1100010002502",1,6,0,0,0,0,7
"G1100010002502103","G1100010002502",3,192,0,6,6,18,225
"G1100010002502104","G1100010002502",2,111,0,0,0,15,128
"G1100010002502105","G1100010002502",4,252,0,0,0,30,286
"G1100010002502106","G1100010002502",0,179,2,1,1,30,213
"G1100010002502201","G1100010002502",4,57,0,0,0,1,62
"G1100010002502202","G1100010002502",0,112,1,0,0,6,119
"G1100010002502203","G1100010002502",6,317,1,1,1,22,348
"G1100010002502204","G1100010002502",4,62,0,3,3,6,78
"G1100010002502205","G1100010002502",1,109,0,0,0,0,110
"G1100010002502206","G1100010002502",1,100,0,0,0,5,106
"G1100010002502207","G1100010002502",2,147,0,0,0,26,175
"G1100010002502208","G1100010002502",0,88,0,0,0,7,95
"G1100010002502301","G1100010002502",11,247,0,1,1,16,276
"G1100010002502302","G1100010002502",4,140,0,0,0,16,160
"G1100010002502303","G1100010002502",9,258,0,3,3,32,305
"G1100010002502304","G1100010002502",11,238,0,0,0,49,298
"G1100010002502305","G1100010002502",42,827,1,4,4,270,1148
"G1100010002502307","G1100010002502",3,219,0,0,0,14,236
"G1100010002502309","G1100010002502",20,176,1,0,0,118,315
"G1100010002502312","G1100010002502",9,121,0,2,2,24,158
"G11000100026101","G11000100026",5,121,0,0,0,0,126
"G11000100026104","G11000100026",13,54,0,0,0,0,67
"G11000100026105","G11000100026",19,33,0,8,8,0,68
"G11000100026106","G11000100026",1,21,0,0,0,0,22
"G11000100026107","G11000100026",13,31,0,0,0,1,45
"G11000100026108","G11000100026",3,35,0,1,1,0,40
"G11000100026201","G11000100026",15,36,0,1,1,0,53
"G11000100026202","G11000100026",7,72,0,2,2,0,83
"G11000100026203","G11000100026",11,27,0,0,0,5,43
"G11000100026204","G11000100026",5,30,0,0,0,2,37
"G11000100026205","G11000100026",24,19,0,0,0,0,43
"G11000100026206","G11000100026",23,52,0,0,0,1,76
"G11000100026207","G11000100026",17,40,0,0,0,2,59
"G11000100026208","G11000100026",38,56,0,5,5,1,105
"G11000100026209","G11000100026",36,60,1,0,0,2,99
"G11000100026210","G11000100026",22,21,0,0,0,2,45
"G11000100026211","G11000100026",13,73,0,1,1,0,88
"G11000100026212","G11000100026",13,62,1,0,0,0,76
"G11000100026214","G11000100026",26,62,0,1,1,1,91
"G11000100026215","G11000100026",18,29,0,6,6,3,62
"G11000100026301","G11000100026",8,35,0,1,1,0,45
"G11000100026302","G11000100026",19,70,0,3,3,0,95
"G11000100026303","G11000100026",11,33,2,0,0,0,46
"G11000100026304","G11000100026",31,20,0,1,1,1,54
"G11000100026305","G11000100026",24,22,0,1,1,1,49
"G11000100026306","G11000100026",39,38,0,3,3,4,87
"G11000100026307","G11000100026",2,32,0,1,1,0,36
"G11000100026308","G11000100026",6,14,0,0,0,0,20
"G11000100026309","G11000100026",135,274,0,5,5,21,440
"G11000100026311","G11000100026",28,6,0,0,0,1,35
"G11000100026312","G11000100026",48,6,0,2,2,1,59
"G11000100026313","G11000100026",20,15,0,0,0,1,36
"G1100010002701101","G1100010002701",485,633,3,42,42,223,1428
"G1100010002701102","G1100010002701",264,176,0,10,10,36,496
"G1100010002701103","G1100010002701",98,20,1,6,6,2,133
"G1100010002701104","G1100010002701",145,70,0,12,12,69,308
"G1100010002701111","G1100010002701",8,20,0,0,0,39,67
"G1100010002701112","G1100010002701",129,33,0,6,6,18,192
"G1100010002701201","G1100010002701",25,72,0,0,0,4,101
"G1100010002701202","G1100010002701",18,31,0,5,5,22,81
"G1100010002701203","G1100010002701",96,149,2,6,6,486,745
"G1100010002701204","G1100010002701",51,145,0,157,157,65,575
"G1100010002701206","G1100010002701",133,145,0,13,13,54,358
"G1100010002701207","G1100010002701",128,398,0,3,3,5,537
"G1100010002701208","G1100010002701",84,65,0,4,4,8,165
"G1100010002702101","G1100010002702",121,435,0,22,22,246,846
"G1100010002702102","G1100010002702",42,200,5,11,11,731,1000
"G1100010002702104","G1100010002702",29,32,0,2,2,134,199
"G1100010002702105","G1100010002702",55,24,0,0,0,51,130
"G1100010002702106","G1100010002702",3,0,0,0,0,0,3
"G1100010002702107","G1100010002702",1,0,0,0,0,0,1
"G1100010002702201","G1100010002702",128,122,0,5,5,313,573
"G1100010002702202","G1100010002702",198,75,0,4,4,32,313
"G1100010002702203","G1100010002702",124,52,1,8,8,40,233
"G1100010002702204","G1100010002702",72,60,0,7,7,47,193
"G1100010002702205","G1100010002702",169,174,2,20,20,102,487
"G1100010002702206","G1100010002702",56,29,0,2,2,89,178
"G1100010002702207","G1100010002702",310,311,2,8,8,36,675
"G1100010002702301","G1100010002702",118,20,0,5,5,10,158
"G1100010002702302","G1100010002702",123,29,1,0,0,25,178
"G1100010002702303","G1100010002702",188,54,2,2,2,29,277
"G1100010002702304","G1100010002702",164,76,0,5,5,39,289
"G1100010002702305","G1100010002702",78,69,0,1,1,3,152
"G1100010002702307","G1100010002702",69,45,0,0,0,12,126
"G1100010002702310","G1100010002702",164,103,1,8,8,32,316
"G1100010002801101","G1100010002801",7,65,0,13,13,17,115
"G1100010002801102","G1100010002801",12,153,0,0,0,31,196
"G1100010002801103","G1100010002801",28,328,0,8,8,165,537
"G1100010002801104","G1100010002801",17,39,0,14,14,32,116
"G1100010002801105","G1100010002801",17,139,0,0,0,125,281
"G1100010002801106","G1100010002801",10,515,4,0,0,27,556
"G1100010002801107","G1100010002801",9,132,1,0,0,161,303
"G1100010002801108","G1100010002801",15,135,0,0,0,43,193
"G1100010002801109","G1100010002801",8,140,0,0,0,45,193
"G1100010002801110","G1100010002801",8,7,0,0,0,6,21
"G1100010002801111","G1100010002801",16,490,0,48,48,380,982
"G1100010002802201","G1100010002802",51,369,0,18,18,154,610
"G1100010002802202","G1100010002802",80,482,2,124,124,579,1391
"G1100010002802203","G1100010002802",13,35,0,28,28,18,122
"G1100010002802204","G1100010002802",5,176,0,1,1,120,303
"G1100010002802205","G1100010002802",62,314,6,32,32,522,968
"G1100010002802206","G1100010002802",21,77,1,7,7,418,531
"G1100010002802207","G1100010002802",48,17,0,9,9,15,98
"G1100010002802208","G1100010002802",41,251,1,5,5,424,727
"G1100010002802209","G1100010002802",4,214,0,1,1,6,226
"G11000100029101","G11000100029",2,72,0,0,0,2,76
"G11000100029102","G11000100029",7,395,1,3,3,57,466
"G11000100029103","G11000100029",3,163,0,0,0,14,180
"G11000100029104","G11000100029",0,203,0,0,0,37,240
"G11000100029105","G11000100029",13,351,0,1,1,14,380
"G11000100029106","G11000100029",8,288,0,1,1,20,318
"G11000100029107","G11000100029",9,133,0,0,0,10,152
"G11000100029108","G11000100029",3,150,0,0,0,44,197
"G11000100029201","G11000100029",5,237,0,0,0,29,271
"G11000100029203","G11000100029",1,117,0,4,4,68,194
"G11000100029204","G11000100029",4,101,2,1,1,7,116
"G11000100029205","G11000100029",1,77,0,3,3,9,93
"G11000100029206","G11000100029",2,111,0,0,0,7,120
"G11000100029207","G11000100029",6,79,1,0,0,10,96
"G11000100029208","G11000100029",0,94,1,0,0,28,123
"G11000100029209","G11000100029",0,119,0,0,0,4,123
"G11000100029210","G11000100029",7,231,0,1,1,32,272
"G11000100029211","G11000100029",22,440,1,0,0,217,680
"G11000100030101","G11000100030",6,99,1,0,0,33,139
"G11000100030102","G11000100030",19,178,0,1,1,3,202
"G11000100030103","G11000100030",23,312,0,1,1,87,424
"G11000100030104","G11000100030",18,218,2,2,2,58,300
"G11000100030105","G11000100030",48,243,1,3,3,58,356
"G11000100030107","G11000100030",3,230,1,0,0,13,247
"G11000100030108","G11000100030",20,571,0,0,0,36,627
"G11000100030109","G11000100030",16,303,4,0,0,28,351
"G11000100031101","G11000100031",0,13,0,0,0,0,13
"G11000100031102","G11000100031",0,110,0,0,0,14,124
"G11000100031103","G11000100031",0,142,0,0,0,21,163
"G11000100031104","G11000100031",0,149,0,0,0,18,167
"G11000100031105","G11000100031",4,173,0,0,0,33,210
"G11000100031106","G11000100031",9,229,0,0,0,26,264
"G11000100031108","G11000100031",6,129,1,0,0,3,139
"G11000100031109","G11000100031",1,245,1,1,1,13,262
"G11000100031110","G11000100031",0,182,0,0,0,14,196
"G11000100031111","G11000100031",1,136,1,0,0,21,159
"G11000100031112","G11000100031",2,172,0,5,5,29,213
"G11000100031113","G11000100031",1,172,0,0,0,18,191
"G11000100031114","G11000100031",6,141,0,2,2,32,183
"G11000100031205","G11000100031",2,135,1,0,0,63,201
"G11000100031206","G11000100031",7,169,0,0,0,22,198
"G11000100031207","G11000100031",3,208,1,0,0,20,232
"G11000100032101","G11000100032",1,151,0,0,0,11,163
"G11000100032103","G11000100032",14,300,0,1,1,21,337
"G11000100032104","G11000100032",1,173,0,0,0,22,196
"G11000100032105","G11000100032",2,136,0,0,0,0,138
"G11000100032106","G11000100032",0,150,0,0,0,0,150
"G11000100032107","G11000100032",1,140,1,0,0,6,148
"G11000100032201","G11000100032",0,114,0,0,0,8,122
"G11000100032202","G11000100032",0,47,0,0,0,0,47
"G11000100032203","G11000100032",1,157,0,0,0,6,164
"G11000100032204","G11000100032",0,127,0,0,0,9,136
"G11000100032205","G11000100032",0,111,0,0,0,1,112
"G11000100032206","G11000100032",6,292,2,4,4,20,328
"G11000100032301","G11000100032",0,82,0,0,0,11,93
"G11000100032302","G11000100032",7,69,2,0,0,6,84
"G11000100032303","G11000100032",0,770,0,4,4,34,812
"G11000100032304","G11000100032",1,151,0,0,0,6,158
"G11000100032305","G11000100032",1,242,5,0,0,49,297
"G11000100032306","G11000100032",3,151,0,3,3,0,160
"G11000100032307","G11000100032",0,130,0,0,0,6,136
"G11000100032308","G11000100032",0,286,1,1,1,28,317
"G11000100032309","G11000100032",3,293,0,0,0,29,325
"G11000100032310","G11000100032",1,115,0,0,0,12,128
"G11000100032403","G11000100032",16,152,1,0,0,25,194
"G11000100032404","G11000100032",0,110,0,0,0,10,120
"G1100010003301101","G1100010003301",0,4,0,0,0,0,4
"G1100010003301103","G1100010003301",10,249,0,0,0,4,263
"G1100010003301104","G1100010003301",27,223,0,0,0,3,253
"G1100010003301105","G1100010003301",15,242,2,0,0,1,260
"G1100010003301106","G1100010003301",10,279,0,5,5,0,299
"G1100010003301201","G1100010003301",22,328,2,5,5,5,367
"G1100010003301202","G1100010003301",29,249,0,0,0,6,284
"G1100010003301203","G1100010003301",7,123,0,0,0,1,131
"G1100010003301204","G1100010003301",2,15,0,0,0,5,22
"G1100010003301205","G1100010003301",10,132,0,1,1,12,156
"G1100010003301206","G1100010003301",16,139,0,3,3,2,163
"G1100010003301301","G1100010003301",6,49,0,0,0,1,56
"G1100010003301302","G1100010003301",6,127,0,0,0,0,133
"G1100010003301303","G1100010003301",13,130,2,0,0,0,145
"G1100010003301304","G1100010003301",13,127,0,0,0,2,142
"G1100010003301305","G1100010003301",1,213,0,1,1,2,218
"G1100010003301306","G1100010003301",16,196,0,0,0,8,220
"G1100010003302101","G1100010003302",15,189,0,0,0,0,204
"G1100010003302102","G1100010003302",8,267,0,1,1,21,298
"G1100010003302103","G1100010003302",5,80,0,0,0,0,85
"G1100010003302104","G1100010003302",16,158,0,0,0,0,174
"G1100010003302105","G1100010003302",9,261,0,0,0,0,270
"G1100010003302106","G1100010003302",11,129,0,0,0,0,140
"G1100010003302201","G1100010003302",7,137,0,0,0,4,148
"G1100010003302202","G1100010003302",9,207,1,0,0,11,228
"G1100010003302203","G1100010003302",2,107,0,6,6,1,122
"G1100010003302204","G1100010003302",10,206,0,0,0,1,217
"G1100010003302206","G1100010003302",4,108,0,0,0,0,112
"G11000100034101","G11000100034",2,713,0,1,1,19,736
"G11000100034103","G11000100034",2,453,1,0,0,3,459
"G11000100034104","G11000100034",0,175,0,2,2,2,181
"G11000100034105","G11000100034",0,122,0,0,0,0,122
"G11000100034107","G11000100034",0,146,2,9,9,5,171
"G11000100034206","G11000100034",0,12,0,0,0,0,12
"G11000100034301","G11000100034",2,579,0,0,0,9,590
"G11000100034302","G11000100034",0,238,8,0,0,8,254
"G11000100034303","G11000100034",1,82,0,0,0,0,83
"G11000100034304","G11000100034",0,105,0,0,0,0,105
"G11000100034305","G11000100034",8,154,0,1,1,0,164
"G11000100034306","G11000100034",9,393,3,0,0,13,418
"G11000100034401","G11000100034",7,120,0,0,0,0,127
"G11000100034402","G11000100034",7,116,1,0,0,1,125
"G11000100034403","G11000100034",6,88,0,0,0,11,105
"G11000100034404","G11000100034",7,139,3,3,3,8,163
"G11000100034406","G11000100034",2,107,0,0,0,5,114
"G11000100034407","G11000100034",5,129,0,1,1,6,142
"G11000100034501","G11000100034",0,53,0,0,0,0,53
"G11000100034502","G11000100034",5,102,0,5,5,8,125
"G11000100034503","G11000100034",9,52,0,0,0,0,61
"G11000100034504","G11000100034",3,53,0,0,0,0,56
"G11000100034505","G11000100034",0,51,0,0,0,3,54
"G11000100034507","G11000100034",12,86,0,0,0,0,98
"G11000100034508","G11000100034",2,73,0,4,4,3,86
"G11000100035101","G11000100035",7,197,1,0,0,6,211
"G11000100035102","G11000100035",0,56,0,0,0,0,56
"G11000100035103","G11000100035",0,212,0,0,0,15,227
"G11000100035104","G11000100035",7,275,1,4,4,13,304
"G11000100035105","G11000100035",3,146,1,0,0,22,172
"G11000100035106","G11000100035",5,177,0,0,0,20,202
"G11000100035107","G11000100035",9,269,0,0,0,36,314
"G11000100035201","G11000100035",9,17,0,0,0,4,30
"G11000100035202","G11000100035",0,50,0,0,0,0,50
"G11000100035203","G11000100035",2,572,1,0,0,27,602
"G11000100035204","G11000100035",0,5,0,0,0,0,5
"G11000100035205","G11000100035",0,13,0,0,0,8,21
"G11000100035206","G11000100035",0,6,0,0,0,0,6
"G11000100035207","G11000100035",0,6,0,0,0,0,6
"G11000100035209","G11000100035",0,17,0,0,0,0,17
"G11000100036101","G11000100036",9,106,0,0,0,4,119
"G11000100036102","G11000100036",13,312,0,1,1,46,373
"G11000100036103","G11000100036",24,442,1,4,4,43,518
"G11000100036104","G11000100036",45,222,3,0,0,44,314
"G11000100036105","G11000100036",50,197,0,0,0,11,258
"G11000100036106","G11000100036",24,402,0,5,5,61,497
"G11000100036107","G11000100036",17,386,2,0,0,107,512
"G11000100036108","G11000100036",21,374,1,4,4,26,430
"G11000100036109","G11000100036",7,99,1,0,0,17,124
"G11000100036111","G11000100036",1,968,2,1,1,5,978
"G11000100036112","G11000100036",3,112,0,1,1,42,159
"G11000100037101","G11000100037",50,586,2,11,11,105,765
"G11000100037103","G11000100037",18,773,0,26,26,38,881
"G11000100037104","G11000100037",32,599,2,1,1,63,698
"G11000100037105","G11000100037",6,386,2,9,9,64,476
"G11000100037106","G11000100037",13,218,4,2,2,55,294
"G11000100037107","G11000100037",19,563,0,2,2,242,828
"G11000100037109","G11000100037",44,553,1,2,2,580,1182
"G11000100037110","G11000100037",58,237,2,3,3,45,348
"G11000100038102","G11000100038",34,149,0,0,0,5,188
"G11000100038103","G11000100038",11,258,0,12,12,47,340
"G11000100038104","G11000100038",34,57,0,5,5,19,120
"G11000100038105","G11000100038",99,211,2,1,1,148,462
"G11000100038106","G11000100038",50,12,0,1,1,41,105
"G11000100038108","G11000100038",69,45,0,9,9,61,193
"G11000100038109","G11000100038",111,233,2,3,3,201,553
"G11000100038110","G11000100038",56,114,0,10,10,132,322
"G11000100038111","G11000100038",168,360,4,5,5,87,629
"G11000100038201","G11000100038",299,436,2,22,22,143,924
"G11000100038203","G11000100038",342,104,0,13,13,22,494
"G11000100038204","G11000100038",27,100,0,0,0,18,145
"G11000100038205","G11000100038",2,86,0,0,0,2,90
"G11000100038206","G11000100038",0,0,0,0,0,6,6
"G11000100039101","G11000100039",224,245,0,36,36,117,658
"G11000100039102","G11000100039",288,444,8,53,53,144,990
"G11000100039103","G11000100039",93,70,0,16,16,232,427
"G11000100039104","G11000100039",149,20,0,6,6,82,263
"G11000100039108","G11000100039",152,151,0,12,12,57,384
"G11000100039201","G11000100039",99,15,0,2,2,6,124
"G11000100039202","G11000100039",144,109,1,7,7,122,390
"G11000100039204","G11000100039",142,93,3,4,4,34,280
"G11000100039205","G11000100039",147,3,0,0,0,1,151
"G11000100039206","G11000100039",117,87,1,4,4,63,276
"G11000100039207","G11000100039",263,36,1,6,6,27,339
"G11000100039208","G11000100039",245,124,0,4,4,62,439
"G1100010004001101","G1100010004001",188,24,0,9,9,64,294
"G1100010004001102","G1100010004001",212,4,1,5,5,12,239
"G1100010004001103","G1100010004001",340,33,4,19,19,88,503
"G1100010004001104","G1100010004001",138,11,0,5,5,6,165
"G1100010004001201","G1100010004001",235,24,0,11,11,36,317
"G1100010004001202","G1100010004001",239,3,0,5,5,7,259
"G1100010004001203","G1100010004001",76,3,0,2,2,6,89
"G1100010004001301","G1100010004001",96,2,0,1,1,5,105
"G1100010004001302","G1100010004001",99,4,1,10,10,26,150
"G1100010004001303","G1100010004001",119,2,0,2,2,12,137
"G1100010004001304","G1100010004001",286,18,0,4,4,21,333
"G1100010004001305","G1100010004001",166,21,1,2,2,13,205
"G1100010004001306","G1100010004001",257,22,2,3,3,16,303
"G1100010004002101","G1100010004002",177,36,5,20,20,54,312
"G1100010004002102","G1100010004002",293,44,2,8,8,46,401
"G1100010004002201","G1100010004002",333,166,4,11,11,34,559
"G1100010004002202","G1100010004002",381,117,1,36,36,68,639
"G1100010004002203","G1100010004002",2,0,0,0,0,0,2
"G1100010004002204","G1100010004002",333,60,0,7,7,30,437
"G1100010004002205","G1100010004002",268,106,1,9,9,30,423
"G1100010004002206","G1100010004002",101,80,0,17,17,129,344
"G11000100041101","G11000100041",3,2,0,0,0,0,5
"G11000100041104","G11000100041",52,1,0,0,0,8,61
"G11000100041105","G11000100041",19,0,0,1,1,1,22
"G11000100041106","G11000100041",357,21,1,11,11,14,415
"G11000100041107","G11000100041",19,0,0,0,0,21,40
"G11000100041108","G11000100041",22,5,0,2,2,3,34
"G11000100041109","G11000100041",29,0,0,0,0,1,30
"G11000100041110","G11000100041",23,0,0,0,0,1,24
"G11000100041112","G11000100041",39,0,0,3,3,4,49
"G11000100041201","G11000100041",561,44,4,34,34,47,724
"G11000100041202","G11000100041",31,0,0,7,7,9,54
"G11000100041203","G11000100041",67,2,0,4,4,8,85
"G11000100041204","G11000100041",30,0,0,1,1,7,39
"G11000100041205","G11000100041",36,0,0,0,0,2,38
"G11000100041206","G11000100041",21,0,0,7,7,5,40
"G11000100041207","G11000100041",142,1,1,2,2,7,155
"G11000100041208","G11000100041",105,5,0,4,4,5,123
"G11000100041209","G11000100041",253,9,0,11,11,23,307
"G11000100041210","G11000100041",55,0,0,1,1,9,66
"G11000100041301","G11000100041",10,3,0,7,7,0,27
"G11000100041302","G11000100041",17,0,0,3,3,0,23
"G11000100041303","G11000100041",131,13,0,17,17,11,189
"G11000100041305","G11000100041",58,2,0,8,8,4,80
"G11000100041306","G11000100041",126,4,0,7,7,12,156
"G11000100041307","G11000100041",32,3,0,6,6,2,49
"G11000100041308","G11000100041",5,0,0,1,1,0,7
"G11000100041310","G11000100041",17,0,0,2,2,3,24
"G11000100041311","G11000100041",58,4,0,3,3,1,69
"G1100010004201101","G1100010004201",144,121,0,4,4,7,280
"G1100010004201102","G1100010004201",97,27,0,3,3,34,164
"G1100010004201103","G1100010004201",193,69,0,8,8,142,420
"G1100010004201104","G1100010004201",52,13,0,3,3,7,78
"G1100010004201105","G1100010004201",123,123,0,9,9,216,480
"G1100010004201107","G1100010004201",160,97,2,11,11,43,324
"G1100010004201202","G1100010004201",208,27,0,4,4,3,246
"G1100010004201203","G1100010004201",307,112,2,11,11,26,469
"G1100010004201204","G1100010004201",305,89,3,17,17,15,446
"G1100010004201205","G1100010004201",4,12,0,0,0,0,16
"G1100010004201206","G1100010004201",162,43,0,5,5,4,219
"G1100010004201207","G1100010004201",55,86,0,2,2,15,160
"G1100010004201208","G1100010004201",264,101,1,18,18,37,439
"G1100010004202101","G1100010004202",126,58,1,33,33,19,270
"G1100010004202102","G1100010004202",105,23,0,4,4,13,149
"G1100010004202103","G1100010004202",150,44,4,17,17,94,326
"G1100010004202104","G1100010004202",183,56,2,15,15,92,363
"G1100010004202105","G1100010004202",0,0,0,0,0,0,0
"G1100010004202106","G1100010004202",5,0,1,0,0,0,6
"G1100010004202107","G1100010004202",174,21,0,6,6,13,220
"G1100010004202108","G1100010004202",214,19,2,8,8,4,255
"G1100010004202110","G1100010004202",51,12,1,3,3,0,70
"G1100010004202111","G1100010004202",96,10,0,9,9,3,127
"G1100010004202112","G1100010004202",309,38,2,21,21,30,421
"G1100010004202113","G1100010004202",141,7,0,8,8,21,185
"G1100010004202114","G1100010004202",225,16,0,5,5,23,274
"G1100010004202115","G1100010004202",2,0,0,0,0,0,2
"G1100010004202116","G1100010004202",59,1,0,1,1,0,62
"G11000100043101","G11000100043",24,74,0,0,0,35,133
"G11000100043102","G11000100043",16,242,4,2,2,185,451
"G11000100043103","G11000100043",9,346,1,9,9,6,380
"G11000100043104","G11000100043",0,2,0,0,0,0,2
"G11000100043105","G11000100043",15,111,0,1,1,8,136
"G11000100043106","G11000100043",142,125,1,6,6,39,319
"G11000100043107","G11000100043",64,14,0,2,2,6,88
"G11000100043108","G11000100043",133,160,1,9,9,40,352
"G11000100043109","G11000100043",65,41,0,0,0,5,111
"G11000100043201","G11000100043",24,40,0,0,0,65,129
"G11000100043202","G11000100043",117,76,1,0,0,7,201
"G11000100043203","G11000100043",109,85,0,0,0,5,199
"G11000100043204","G11000100043",61,41,0,3,3,5,113
"G11000100043205","G11000100043",75,90,0,1,1,7,174
"G11000100043206","G11000100043",108,91,0,8,8,14,229
"G11000100043207","G11000100043",1,232,2,2,2,61,300
"G11000100044101","G11000100044",3,75,0,1,1,35,115
"G11000100044102","G11000100044",14,125,0,1,1,21,162
"G11000100044103","G11000100044",26,83,0,1,1,27,138
"G11000100044104","G11000100044",4,37,0,0,0,0,41
"G11000100044105","G11000100044",7,117,0,0,0,78,202
"G11000100044107","G11000100044",1,50,0,0,0,1,52
"G11000100044109","G11000100044",0,63,0,0,0,7,70
"G11000100044110","G11000100044",0,35,0,0,0,0,35
"G11000100044201","G11000100044",23,48,0,0,0,1,72
"G11000100044202","G11000100044",48,56,0,5,5,6,120
"G11000100044203","G11000100044",15,34,0,0,0,0,49
"G11000100044204","G11000100044",2,85,0,5,5,49,146
"G11000100044205","G11000100044",15,65,0,2,2,1,85
"G11000100044206","G11000100044",10,67,0,2,2,21,102
"G11000100044207","G11000100044",48,64,0,2,2,27,143
"G11000100044208","G11000100044",14,151,0,0,0,20,185
"G11000100044209","G11000100044",9,37,0,0,0,0,46
"G11000100045101","G11000100045",3,108,0,0,0,3,114
"G11000100045103","G11000100045",2,75,1,0,0,15,93
"G11000100045104","G11000100045",0,36,0,0,0,0,36
"G11000100045105","G11000100045",0,28,0,0,0,0,28
"G11000100045107","G11000100045",0,59,0,12,12,1,84
"G11000100045108","G11000100045",0,5,0,0,0,0,5
"G11000100045201","G11000100045",0,60,0,0,0,0,60
"G11000100045202","G11000100045",0,47,0,0,0,0,47
"G11000100045203","G11000100045",7,93,0,0,0,2,102
"G11000100045205","G11000100045",10,39,0,0,0,4,53
"G11000100045206","G11000100045",8,34,0,0,0,0,42
"G11000100045207","G11000100045",3,131,4,2,2,2,144
"G11000100045208","G11000100045",7,28,0,0,0,3,38
"G11000100045209","G11000100045",24,177,0,0,0,9,210
"G11000100045210","G11000100045",15,138,0,1,1,0,155
"G11000100045211","G11000100045",0,6,0,0,0,0,6
"G11000100046101","G11000100046",13,107,0,0,0,3,123
"G11000100046102","G11000100046",7,231,0,2,2,12,254
"G11000100046103","G11000100046",3,173,0,0,0,0,176
"G11000100046104","G11000100046",8,190,0,0,0,2,200
"G11000100046105","G11000100046",13,322,0,4,4,17,360
"G11000100046106","G11000100046",9,140,5,2,2,4,162
"G11000100046201","G11000100046",0,48,0,0,0,0,48
"G11000100046202","G11000100046",6,55,0,1,1,6,69
"G11000100046203","G11000100046",1,506,0,2,2,8,519
"G11000100046204","G11000100046",1,60,0,0,0,7,68
"G11000100046205","G11000100046",7,66,0,0,0,23,96
"G11000100046206","G11000100046",18,124,1,0,0,1,144
"G11000100046207","G11000100046",1,273,0,0,0,0,274
"G11000100046208","G11000100046",10,326,1,7,7,12,363
"G11000100046301","G11000100046",5,104,0,5,5,10,129
"G11000100046302","G11000100046",9,132,0,0,0,27,168
"G11000100046304","G11000100046",7,117,0,3,3,5,135
"G11000100046305","G11000100046",9,124,0,1,1,2,137
"G11000100046306","G11000100046",3,95,0,0,0,0,98
"G11000100046307","G11000100046",13,105,1,0,0,0,119
"G11000100047101","G11000100047",11,775,5,4,4,6,805
"G11000100047104","G11000100047",7,30,0,1,1,1,40
"G11000100047201","G11000100047",17,1797,7,4,4,19,1848
"G11000100047202","G11000100047",65,327,0,34,34,0,460
"G11000100047203","G11000100047",2,337,0,0,0,0,339
"G11000100047302","G11000100047",4,356,10,3,3,1,377
"G11000100047402","G11000100047",17,160,0,1,1,0,179
"G11000100047420","G11000100047",4,4,0,0,0,0,8
"G11000100047501","G11000100047",8,26,0,22,22,1,79
"G11000100047502","G11000100047",2,6,0,0,0,0,8
"G11000100047503","G11000100047",11,4,0,0,0,0,15
"G11000100047504","G11000100047",4,62,0,0,0,1,67
"G11000100047506","G11000100047",0,21,0,0,0,0,21
"G11000100047508","G11000100047",12,328,1,12,12,4,369
"G11000100047509","G11000100047",0,19,0,0,0,0,19
"G11000100047510","G11000100047",0,0,0,0,0,0,0
"G1100010004801101","G1100010004801",0,5,0,0,0,0,5
"G1100010004801102","G1100010004801",0,13,0,0,0,0,13
"G1100010004801103","G1100010004801",1,114,0,0,0,0,115
"G1100010004801104","G1100010004801",3,63,0,5,5,3,79
"G1100010004801105","G1100010004801",0,48,0,0,0,0,48
"G1100010004801106","G1100010004801",0,17,0,0,0,0,17
"G1100010004801107","G1100010004801",6,59,0,0,0,0,65
"G1100010004801108","G1100010004801",4,139,0,6,6,3,158
"G1100010004801201","G1100010004801",13,186,1,12,12,3,227
"G1100010004801202","G1100010004801",14,154,0,4,4,25,201
"G1100010004801203","G1100010004801",0,179,0,7,7,15,208
"G1100010004801205","G1100010004801",2,24,0,5,5,0,36
"G1100010004801206","G1100010004801",6,55,0,0,0,1,62
"G1100010004801207","G1100010004801",8,92,0,0,0,0,100
"G1100010004801208","G1100010004801",17,124,0,0,0,8,149
"G1100010004801301","G1100010004801",10,103,0,1,1,3,118
"G1100010004801303","G1100010004801",16,106,0,0,0,0,122
"G1100010004801304","G1100010004801",16,133,0,0,0,9,158
"G1100010004801307","G1100010004801",5,69,0,0,0,1,75
"G1100010004801308","G1100010004801",7,87,0,0,0,0,94
"G1100010004801320","G1100010004801",2,130,0,0,0,11,143
"G1100010004802104","G1100010004802",58,84,0,6,6,15,169
"G1100010004802105","G1100010004802",36,118,0,16,16,3,189
"G1100010004802106","G1100010004802",8,80,0,0,0,0,88
"G1100010004802109","G1100010004802",0,32,0,4,4,0,40
"G1100010004802110","G1100010004802",75,138,0,34,34,2,283
"G1100010004802120","G1100010004802",3,415,0,0,0,9,427
"G1100010004802201","G1100010004802",18,50,0,27,27,0,122
"G1100010004802202","G1100010004802",0,5,0,0,0,0,5
"G1100010004802203","G1100010004802",8,337,0,0,0,4,349
"G1100010004802205","G1100010004802",0,148,0,0,0,2,150
"G1100010004802208","G1100010004802",8,682,1,35,35,35,796
"G1100010004802209","G1100010004802",6,132,0,10,10,6,164
"G1100010004802220","G1100010004802",0,437,0,0,0,2,439
"G1100010004901101","G1100010004901",1,348,0,2,2,6,359
"G1100010004901102","G1100010004901",1,172,0,0,0,0,173
"G1100010004901103","G1100010004901",18,164,0,0,0,3,185
"G1100010004901104","G1100010004901",25,76,0,0,0,7,108
"G1100010004901105","G1100010004901",21,112,0,0,0,9,142
"G1100010004901106","G1100010004901",2,175,0,0,0,1,178
"G1100010004901201","G1100010004901",3,46,1,5,5,8,68
"G1100010004901202","G1100010004901",12,28,0,0,0,9,49
"G1100010004901203","G1100010004901",0,19,0,0,0,9,28
"G1100010004901204","G1100010004901",12,245,0,3,3,3,266
"G1100010004901205","G1100010004901",3,133,5,4,4,3,152
"G1100010004901207","G1100010004901",27,44,0,0,0,2,73
"G1100010004901301","G1100010004901",32,39,1,0,0,4,76
"G1100010004901302","G1100010004901",14,20,0,0,0,3,37
"G1100010004901305","G1100010004901",10,34,0,0,0,0,44
"G1100010004901306","G1100010004901",9,59,0,0,0,1,69
"G1100010004902101","G1100010004902",5,356,0,0,0,6,367
"G1100010004902102","G1100010004902",1,33,1,0,0,1,36
"G1100010004902103","G1100010004902",23,145,1,2,2,82,255
"G1100010004902104","G1100010004902",27,47,0,0,0,2,76
"G1100010004902105","G1100010004902",33,64,4,3,3,251,358
"G1100010004902106","G1100010004902",55,73,0,1,1,55,185
"G1100010004902107","G1100010004902",0,19,0,0,0,0,19
"G1100010004902108","G1100010004902",1,15,0,0,0,0,16
"G1100010004902203","G1100010004902",18,108,0,10,10,4,150
"G1100010004902204","G1100010004902",11,110,0,0,0,1,122
"G1100010004902209","G1100010004902",0,2,0,0,0,0,2
"G11000100050102","G11000100050",6,101,0,1,1,33,142
"G11000100050103","G11000100050",0,10,0,0,0,0,10
"G11000100050104","G11000100050",35,98,0,0,0,9,142
"G11000100050105","G11000100050",7,14,0,0,0,2,23
"G11000100050106","G11000100050",19,20,0,0,0,8,47
"G11000100050107","G11000100050",45,117,1,11,11,12,197
"G11000100050108","G11000100050",18,39,0,0,0,5,62
"G11000100050111","G11000100050",18,58,0,0,0,3,79
"G11000100050201","G11000100050",16,158,0,6,6,3,189
"G11000100050202","G11000100050",69,35,0,15,15,6,140
"G11000100050203","G11000100050",145,89,1,2,2,56,295
"G11000100050204","G11000100050",3,34,0,1,1,60,99
"G11000100050205","G11000100050",26,80,0,7,7,87,207
"G11000100050207","G11000100050",107,170,3,73,73,482,908
"G11000100050208","G11000100050",69,291,0,2,2,5,369
"G11000100050209","G11000100050",127,297,5,38,38,46,551
"G11000100050210","G11000100050",16,575,3,1,1,44,640
"G11000100050301","G11000100050",51,16,1,0,0,5,73
"G11000100050302","G11000100050",105,63,1,2,2,9,182
"G11000100050303","G11000100050",85,114,1,16,16,13,245
"G11000100050304","G11000100050",3,892,1,2,2,10,910
"G11000100050305","G11000100050",7,24,0,0,0,4,35
"G11000100050306","G11000100050",49,67,0,18,18,70,222
"G11000100050401","G11000100050",34,45,0,0,0,0,79
"G11000100050402","G11000100050",91,77,1,5,5,4,183
"G11000100050403","G11000100050",77,103,0,2,2,3,187
"G11000100050404","G11000100050",111,102,2,7,7,10,239
"G11000100050405","G11000100050",29,76,0,0,0,10,115
"G11000100050406","G11000100050",6,53,0,0,0,15,74
"G11000100051102","G11000100051",87,2,0,27,27,21,164
"G11000100051105","G11000100051",137,139,2,3,3,28,312
"G11000100051106","G11000100051",1,0,0,0,0,6,7
"G11000100051215","G11000100051",332,157,1,32,32,20,574
"G1100010005210101","G1100010005210",33,33,0,1,1,87,155
"G1100010005210102","G1100010005210",144,51,1,0,0,9,205
"G1100010005210103","G1100010005210",240,87,2,19,19,36,403
"G1100010005210104","G1100010005210",82,355,0,16,16,22,491
"G1100010005210105","G1100010005210",137,45,0,1,1,1,185
"G1100010005210108","G1100010005210",74,128,1,7,7,1,218
"G1100010005210109","G1100010005210",4,1,0,0,0,1,6
"G1100010005210110","G1100010005210",228,191,2,35,35,65,556
"G1100010005210111","G1100010005210",413,512,6,64,64,96,1155
"G1100010005210202","G1100010005210",59,5,0,2,2,1,69
"G1100010005210203","G1100010005210",76,9,0,2,2,1,90
"G1100010005210204","G1100010005210",180,27,0,16,16,16,255
"G1100010005210211","G1100010005210",266,104,0,14,14,26,424
"G1100010005210212","G1100010005210",90,54,0,2,2,13,161
"G1100010005210213","G1100010005210",116,39,0,3,3,15,176
"G1100010005210214","G1100010005210",67,32,0,1,1,2,103
"G1100010005220101","G1100010005220",3,0,0,0,0,0,3
"G1100010005220102","G1100010005220",292,171,1,92,92,179,827
"G1100010005220103","G1100010005220",1,0,0,0,0,0,1
"G1100010005301101","G1100010005301",184,56,0,9,9,45,303
"G1100010005301102","G1100010005301",236,63,0,16,16,88,419
"G1100010005301104","G1100010005301",79,78,0,1,1,132,291
"G1100010005301105","G1100010005301",129,59,0,18,18,60,284
"G1100010005301106","G1100010005301",66,5,0,8,8,17,104
"G1100010005301107","G1100010005301",422,48,0,18,18,62,568
"G1100010005301108","G1100010005301",359,68,2,27,27,89,572
"G1100010005301201","G1100010005301",112,62,0,13,13,272,472
"G1100010005301202","G1100010005301",310,16,2,10,10,85,433
"G1100010005301203","G1100010005301",439,21,3,12,12,48,535
"G1100010005301204","G1100010005301",2,0,0,0,0,0,2
"G1100010005301206","G1100010005301",732,74,2,116,116,64,1104
"G1100010005301207","G1100010005301",175,21,0,17,17,10,240
"G1100010005302103","G1100010005302",111,13,0,5,5,9,143
"G1100010005302105","G1100010005302",0,2,0,2,2,0,6
"G1100010005302106","G1100010005302",0,1,0,0,0,0,1
"G1100010005302110","G1100010005302",5,0,0,0,0,1,6
"G1100010005302205","G1100010005302",34,1,0,0,0,0,35
"G1100010005401103","G1100010005401",138,3,0,4,4,8,157
"G1100010005401202","G1100010005401",2,3,0,0,0,2,7
"G1100010005401203","G1100010005401",115,4,0,0,0,4,123
"G1100010005401204","G1100010005401",300,17,1,14,14,21,367
"G1100010005401205","G1100010005401",214,44,4,59,59,44,424
"G1100010005401207","G1100010005401",69,9,0,3,3,2,86
"G1100010005401209","G1100010005401",2,0,0,0,0,0,2
"G1100010005402103","G1100010005402",0,0,0,0,0,0,0
"G1100010005402105","G1100010005402",2,0,0,0,0,0,2
"G1100010005501101","G1100010005501",59,2,0,2,2,0,65
"G1100010005501102","G1100010005501",53,1,0,2,2,0,58
"G1100010005501103","G1100010005501",38,1,0,2,2,4,47
"G1100010005501107","G1100010005501",54,1,0,5,5,3,68
"G1100010005501108","G1100010005501",54,2,0,6,6,9,77
"G1100010005501201","G1100010005501",403,19,0,40,40,26,528
"G1100010005501203","G1100010005501",1,0,0,0,0,0,1
"G1100010005501204","G1100010005501",0,0,0,0,0,0,0
"G1100010005501207","G1100010005501",90,7,0,4,4,2,107
"G1100010005501209","G1100010005501",185,16,3,20,20,18,262
"G1100010005501210","G1100010005501",37,1,0,1,1,0,40
"G1100010005501211","G1100010005501",327,188,3,43,43,42,646
"G1100010005501212","G1100010005501",262,8,1,12,12,16,311
"G1100010005501213","G1100010005501",163,10,1,3,3,7,187
"G1100010005501214","G1100010005501",366,11,0,19,19,27,442
"G1100010005501215","G1100010005501",50,10,0,0,0,1,61
"G1100010005502301","G1100010005502",38,0,0,4,4,0,46
"G1100010005502302","G1100010005502",310,11,0,10,10,16,357
"G1100010005502306","G1100010005502",168,0,0,1,1,3,173
"G1100010005502401","G1100010005502",259,8,4,8,8,18,305
"G1100010005502404","G1100010005502",121,4,0,2,2,14,143
"G1100010005502405","G1100010005502",94,6,0,0,0,7,107
"G1100010005502406","G1100010005502",1,4,0,0,0,1,6
"G1100010005502408","G1100010005502",151,3,0,7,7,12,180
"G1100010005502410","G1100010005502",35,1,0,1,1,4,42
"G11000100056101","G11000100056",314,68,0,25,25,20,452
"G11000100056102","G11000100056",1,0,0,0,0,0,1
"G11000100056103","G11000100056",147,21,0,26,26,28,248
"G11000100056104","G11000100056",6,0,0,0,0,0,6
"G11000100056106","G11000100056",320,13,4,29,29,28,423
"G11000100056107","G11000100056",82,1,0,5,5,5,98
"G11000100056109","G11000100056",517,8,0,61,61,32,679
"G11000100056201","G11000100056",94,2,0,6,6,6,114
"G11000100056202","G11000100056",1,0,0,0,0,0,1
"G11000100056204","G11000100056",46,1,1,2,2,3,55
"G11000100056205","G11000100056",237,8,1,25,25,8,304
"G11000100056207","G11000100056",81,63,1,0,0,13,158
"G11000100056208","G11000100056",712,10,0,18,18,34,792
"G11000100056210","G11000100056",408,2,0,15,15,26,466
"G11000100056211","G11000100056",101,6,0,8,8,2,125
"G11000100056212","G11000100056",792,40,3,45,45,74,999
"G1100010005701102","G1100010005701",103,3,1,12,12,3,134
"G1100010005701103","G1100010005701",4,15,0,1,1,0,21
"G1100010005701104","G1100010005701",682,30,0,45,45,20,822
"G1100010005701105","G1100010005701",34,14,1,41,41,12,143
"G1100010005701108","G1100010005701",402,27,1,66,66,23,585
"G1100010005701203","G1100010005701",298,6,0,15,15,4,338
"G1100010005701205","G1100010005701",1119,52,1,70,70,40,1352
"G1100010005701206","G1100010005701",550,41,1,61,61,38,752
"G1100010005701502","G1100010005701",0,3,0,0,0,0,3
"G1100010005701503","G1100010005701",392,11,2,51,51,20,527
"G1100010005701504","G1100010005701",188,8,0,9,9,3,217
"G1100010005701506","G1100010005701",331,29,2,41,41,16,460
"G1100010005701508","G1100010005701",182,10,0,11,11,3,217
"G1100010005702104","G1100010005702",7,6,0,0,0,1,14
"G1100010005702211","G1100010005702",1,0,0,0,0,1,2
"G11000100058102","G11000100058",0,0,0,49,49,0,98
"G11000100058105","G11000100058",0,0,0,1,1,0,2
"G11000100058113","G11000100058",2,5,0,282,282,15,586
"G11000100058114","G11000100058",50,124,3,98,98,27,400
"G11000100058115","G11000100058",0,0,0,28,28,2,58
"G11000100058116","G11000100058",0,0,0,13,13,0,26
"G11000100058117","G11000100058",1,5,0,47,47,0,100
"G11000100058118","G11000100058",7,20,0,1,1,0,29
"G11000100058126","G11000100058",4,0,0,0,0,0,4
"G11000100058201","G11000100058",3,0,0,0,0,0,3
"G11000100059102","G11000100059",0,2,0,0,0,0,2
"G11000100059110","G11000100059",22,68,0,0,0,1,91
"G11000100059111","G11000100059",62,460,0,11,11,21,565
"G11000100059116","G11000100059",74,624,2,2,2,1,705
"G11000100059203","G11000100059",0,53,2,0,0,2,57
"G11000100059404","G11000100059",9,58,2,0,0,10,79
"G11000100059407","G11000100059",20,17,0,0,0,4,41
"G11000100059408","G11000100059",9,91,1,18,18,26,163
"G11000100059411","G11000100059",8,264,1,8,8,2,291
"G1100010006001304","G1100010006001",697,808,4,42,42,76,1669
"G1100010006001306","G1100010006001",187,190,5,12,12,40,446
"G1100010006020101","G1100010006020",0,0,0,0,0,0,0
"G1100010006020102","G1100010006020",1,49,0,0,0,0,50
"G1100010006020103","G1100010006020",4,260,0,0,0,15,279
"G1100010006020104","G1100010006020",0,237,0,0,0,0,237
"G1100010006020105","G1100010006020",0,225,0,0,0,0,225
"G11000100061207","G11000100061",34,26,1,0,0,0,61
"G11000100061208","G11000100061",49,46,0,5,5,4,109
"G11000100061209","G11000100061",73,11,0,2,2,7,95
"G11000100061210","G11000100061",288,241,2,26,26,7,590
"G11000100061211","G11000100061",184,334,1,27,27,46,619
"G11000100061212","G11000100061",371,223,1,27,27,18,667
"G1100010006201101","G1100010006201",0,0,0,0,0,3,3
"G1100010006201104","G1100010006201",10,0,0,1,1,0,12
"G1100010006201108","G1100010006201",0,0,0,0,0,0,0
"G1100010006201203","G1100010006201",37,0,0,0,0,0,37
"G1100010006202101","G1100010006202",14,0,0,0,0,1,15
"G1100010006202102","G1100010006202",3,0,0,0,0,1,4
"G1100010006202106","G1100010006202",2,0,0,0,0,0,2
"G1100010006202201","G1100010006202",1,0,0,0,0,0,1
"G1100010006202203","G1100010006202",7,0,0,0,0,0,7
"G1100010006202301","G1100010006202",0,4,0,0,0,0,4
"G1100010006202303","G1100010006202",2,1,0,0,0,0,3
"G1100010006202319","G1100010006202",1,1,0,0,0,0,2
"G1100010006202322","G1100010006202",0,0,0,0,0,0,0
"G1100010006202329","G1100010006202",1,0,0,0,0,0,1
"G1100010006202330","G1100010006202",0,1,0,0,0,0,1
"G1100010006202331","G1100010006202",0,2,0,0,0,0,2
"G1100010006202332","G1100010006202",1,5,0,0,0,4,10
"G1100010006202422","G1100010006202",0,3,0,0,0,0,3
"G1100010006301102","G1100010006301",1015,480,3,22,22,42,1584
"G1100010006301103","G1100010006301",5,479,0,0,0,6,490
"G1100010006301105","G1100010006301",117,3,0,1,1,3,125
"G1100010006301120","G1100010006301",676,762,11,31,31,54,1565
"G1100010006302101","G1100010006302",266,55,1,5,5,23,355
"G1100010006410101","G1100010006410",2,200,0,1,1,0,204
"G1100010006410105","G1100010006410",1,343,1,0,0,2,347
"G1100010006410106","G1100010006410",0,152,0,0,0,1,153
"G1100010006410107","G1100010006410",0,275,0,4,4,4,287
"G1100010006410108","G1100010006410",0,39,0,0,0,0,39
"G1100010006410108A","G1100010006410",3,81,0,0,0,3,87
"G1100010006410109","G1100010006410",14,150,0,0,0,1,165
"G1100010006410109A","G1100010006410",2,99,0,0,0,1,102
"G1100010006410109B","G1100010006410",7,77,0,0,0,11,95
"G1100010006410110","G1100010006410",10,30,0,3,3,0,46
"G1100010006410110A","G1100010006410",2,99,2,0,0,0,103
"G1100010006410110B","G1100010006410",0,98,0,0,0,0,98
"G1100010006410111","G1100010006410",0,97,0,0,0,0,97
"G1100010006410111A","G1100010006410",3,195,0,0,0,1,199
"G1100010006410201","G1100010006410",0,229,0,0,0,0,229
"G1100010006410202","G1100010006410",0,223,7,0,0,10,240
"G1100010006410206","G1100010006410",0,32,0,0,0,1,33
"G1100010006510101","G1100010006510",47,1,0,10,10,1,69
"G1100010006510102","G1100010006510",144,10,1,3,3,8,169
"G1100010006510103","G1100010006510",30,1,0,1,1,3,36
"G1100010006510104","G1100010006510",102,3,0,1,1,0,107
"G1100010006510106","G1100010006510",40,9,0,0,0,0,49
"G1100010006510107","G1100010006510",74,0,0,2,2,2,80
"G1100010006510108","G1100010006510",30,6,0,0,0,2,38
"G1100010006510120","G1100010006510",114,11,0,7,7,3,142
"G1100010006510201","G1100010006510",80,18,1,4,4,0,107
"G1100010006510202","G1100010006510",68,2,0,1,1,0,72
"G1100010006510203","G1100010006510",51,24,0,1,1,1,78
"G1100010006510204","G1100010006510",81,6,0,1,1,2,91
"G1100010006510205","G1100010006510",82,23,0,0,0,11,116
"G1100010006510207","G1100010006510",123,5,0,1,1,4,134
"G1100010006510302","G1100010006510",150,28,0,6,6,3,193
"G1100010006510305","G1100010006510",145,34,0,1,1,0,181
"G1100010006510401","G1100010006510",176,14,0,1,1,10,202
"G1100010006510402","G1100010006510",39,3,0,2,2,1,47
"G1100010006510403","G1100010006510",31,8,0,3,3,0,45
"G1100010006510404","G1100010006510",122,21,0,1,1,1,146
"G1100010006510406","G1100010006510",139,5,1,7,7,2,161
"G1100010006510501","G1100010006510",66,1,0,0,0,0,67
"G1100010006510502","G1100010006510",108,6,0,1,1,2,118
"G11000100066101","G11000100066",125,5,2,1,1,2,136
"G11000100066102","G11000100066",158,30,2,5,5,3,203
"G11000100066103","G11000100066",60,7,0,0,0,1,68
"G11000100066104","G11000100066",73,5,0,2,2,3,85
"G11000100066105","G11000100066",221,15,1,3,3,9,252
"G11000100066106","G11000100066",111,5,0,2,2,12,132
"G11000100066201","G11000100066",38,1,0,0,0,1,40
"G11000100066202","G11000100066",81,3,0,0,0,4,88
"G11000100066203","G11000100066",95,3,1,0,0,1,100
"G11000100066206","G11000100066",41,3,0,1,1,1,47
"G11000100066220","G11000100066",85,8,0,19,19,5,136
"G11000100066301","G11000100066",68,6,1,0,0,1,76
"G11000100066302","G11000100066",145,14,0,2,2,6,169
"G11000100066303","G11000100066",7,0,0,0,0,0,7
"G11000100066306","G11000100066",97,2,0,1,1,0,101
"G11000100066308","G11000100066",93,1,1,3,3,1,102
"G11000100066309","G11000100066",85,1,0,0,0,2,88
"G1100010006710101","G1100010006710",69,116,1,1,1,2,190
"G1100010006710102","G1100010006710",134,90,0,6,6,5,241
"G1100010006710103","G1100010006710",5,0,0,0,0,0,5
"G1100010006710104","G1100010006710",138,96,0,4,4,12,254
"G1100010006710105","G1100010006710",34,165,0,8,8,3,218
"G1100010006710107","G1100010006710",3,13,0,0,0,0,16
"G1100010006710108","G1100010006710",67,62,0,2,2,1,134
"G1100010006710109","G1100010006710",36,16,1,0,0,0,53
"G1100010006710201","G1100010006710",11,14,0,0,0,0,25
"G1100010006710202","G1100010006710",61,19,0,1,1,0,82
"G1100010006710203","G1100010006710",138,20,1,2,2,3,166
"G1100010006710204","G1100010006710",103,34,0,0,0,0,137
"G1100010006710205","G1100010006710",83,31,1,1,1,1,118
"G1100010006710206","G1100010006710",76,32,0,0,0,1,109
"G1100010006710207","G1100010006710",140,25,1,3,3,6,178
"G1100010006710208","G1100010006710",158,34,0,0,0,7,199
"G1100010006710301","G1100010006710",113,90,0,0,0,4,207
"G1100010006710302","G1100010006710",72,20,0,5,5,1,103
"G1100010006710303","G1100010006710",105,12,0,4,4,0,125
"G1100010006710304","G1100010006710",82,18,0,4,4,5,113
"G1100010006710306","G1100010006710",114,29,0,0,0,5,148
"G1100010006710307","G1100010006710",124,18,0,3,3,1,149
"G1100010006710401","G1100010006710",51,3,0,1,1,0,56
"G1100010006710402","G1100010006710",75,26,2,1,1,7,112
"G1100010006710403","G1100010006710",95,10,0,0,0,0,105
"G1100010006710404","G1100010006710",35,4,1,0,0,0,40
"G1100010006710405","G1100010006710",65,20,0,1,1,0,87
"G1100010006710406","G1100010006710",100,21,1,0,0,0,122
"G1100010006710407","G1100010006710",28,3,0,1,1,0,33
"G1100010006801101","G1100010006801",13,206,0,0,0,2,221
"G1100010006801102","G1100010006801",4,196,0,1,1,3,205
"G1100010006801103","G1100010006801",10,120,0,0,0,0,130
"G1100010006801104","G1100010006801",6,211,0,0,0,3,220
"G1100010006801105","G1100010006801",16,114,0,0,0,5,135
"G1100010006801106","G1100010006801",9,159,0,0,0,4,172
"G1100010006801107","G1100010006801",10,146,0,0,0,1,157
"G1100010006801108","G1100010006801",12,134,0,1,1,1,149
"G1100010006801109","G1100010006801",1,37,0,0,0,0,38
"G1100010006801110","G1100010006801",13,175,0,1,1,1,191
"G1100010006801201","G1100010006801",10,158,1,0,0,0,169
"G1100010006801202","G1100010006801",8,68,0,4,4,2,86
"G1100010006801203","G1100010006801",5,97,0,0,0,4,106
"G1100010006801204","G1100010006801",20,197,0,2,2,6,227
"G1100010006801205","G1100010006801",20,103,0,1,1,0,125
"G1100010006801206","G1100010006801",4,78,0,0,0,15,97
"G1100010006802101","G1100010006802",8,83,0,0,0,0,91
"G1100010006802102","G1100010006802",6,197,0,0,0,1,204
"G1100010006802104","G1100010006802",14,195,1,0,0,3,213
"G1100010006802105","G1100010006802",3,133,1,2,2,3,144
"G1100010006802106","G1100010006802",16,123,0,2,2,0,143
"G1100010006802107","G1100010006802",31,111,0,0,0,0,142
"G1100010006802201","G1100010006802",46,130,0,11,11,5,203
"G1100010006802202","G1100010006802",30,169,0,2,2,7,210
"G1100010006802203","G1100010006802",8,167,0,0,0,3,178
"G1100010006802204","G1100010006802",6,98,0,0,0,0,104
"G1100010006802206","G1100010006802",21,79,0,0,0,1,101
"G1100010006802301","G1100010006802",4,31,0,0,0,2,37
"G1100010006802302","G1100010006802",20,108,0,3,3,0,134
"G1100010006802303","G1100010006802",16,101,0,0,0,1,118
"G1100010006802304","G1100010006802",37,123,1,0,0,5,166
"G1100010006802305","G1100010006802",20,89,1,0,0,0,110
"G1100010006802308","G1100010006802",1,73,0,0,0,2,76
"G1100010006804107","G1100010006804",166,2872,9,7,7,118,3179
"G1100010006804108","G1100010006804",0,8,0,0,0,0,8
"G11000100069101","G11000100069",52,129,1,5,5,1,193
"G11000100069102","G11000100069",16,136,1,0,0,1,154
"G11000100069103","G11000100069",22,48,0,2,2,1,75
"G11000100069104","G11000100069",17,271,2,0,0,4,294
"G11000100069105","G11000100069",9,25,0,0,0,5,39
"G11000100069106","G11000100069",7,17,0,0,0,3,27
"G11000100069201","G11000100069",50,93,0,0,0,0,143
"G11000100069202","G11000100069",14,11,0,0,0,0,25
"G11000100069203","G11000100069",7,7,0,0,0,1,15
"G11000100069204","G11000100069",66,107,1,7,7,6,194
"G11000100069205","G11000100069",6,5,0,0,0,0,11
"G11000100069206","G11000100069",12,34,0,0,0,3,49
"G11000100069207","G11000100069",59,55,0,3,3,0,120
"G11000100069208","G11000100069",12,17,0,0,0,0,29
"G11000100069209","G11000100069",26,43,0,1,1,2,73
"G11000100069210","G11000100069",5,40,1,6,6,1,59
"G11000100069301","G11000100069",16,5,0,0,0,0,21
"G11000100069302","G11000100069",112,57,0,1,1,2,173
"G11000100069303","G11000100069",29,1,0,0,0,0,30
"G11000100069304","G11000100069",4,0,5,0,0,0,9
"G11000100069305","G11000100069",44,7,0,0,0,6,57
"G11000100069306","G11000100069",63,43,1,1,1,2,111
"G11000100069307","G11000100069",40,20,0,1,1,1,63
"G11000100069308","G11000100069",56,33,0,0,0,3,92
"G11000100069310","G11000100069",31,9,0,1,1,6,48
"G1100010007010106","G1100010007010",24,0,0,2,2,1,29
"G1100010007010107","G1100010007010",26,4,2,1,1,6,40
"G1100010007010108","G1100010007010",52,16,2,9,9,0,88
"G1100010007010109","G1100010007010",123,23,0,3,3,4,156
"G1100010007010110","G1100010007010",24,1,0,0,0,0,25
"G1100010007010112","G1100010007010",79,24,2,0,0,3,108
"G1100010007010113","G1100010007010",14,2,0,0,0,0,16
"G1100010007010202","G1100010007010",9,1,0,0,0,4,14
"G1100010007010203","G1100010007010",124,26,3,3,3,4,163
"G1100010007010204","G1100010007010",305,95,1,3,3,26,433
"G1100010007010205","G1100010007010",86,65,0,14,14,14,193
"G1100010007010303","G1100010007010",145,11,1,0,0,4,161
"G1100010007010304","G1100010007010",140,20,0,7,7,3,177
"G1100010007010305","G1100010007010",92,26,0,1,1,5,125
"G1100010007010306","G1100010007010",16,18,0,0,0,0,34
"G1100010007010310","G1100010007010",121,78,0,2,2,2,205
"G1100010007010312","G1100010007010",72,41,2,0,0,0,115
"G1100010007010313","G1100010007010",83,21,0,1,1,7,113
"G11000100071101","G11000100071",10,3,0,8,8,0,29
"G11000100071102","G11000100071",49,15,0,5,5,0,74
"G11000100071103","G11000100071",51,100,1,0,0,13,165
"G11000100071104","G11000100071",7,888,8,0,0,12,915
"G11000100071105","G11000100071",6,36,0,0,0,3,45
"G11000100071106","G11000100071",12,67,0,2,2,0,83
"G11000100071107","G11000100071",7,41,1,0,0,1,50
"G11000100071201","G11000100071",37,200,0,1,1,1,240
"G11000100071202","G11000100071",20,37,0,3,3,1,64
"G11000100071203","G11000100071",24,39,0,0,0,6,69
"G11000100071204","G11000100071",6,77,0,0,0,2,85
"G11000100071205","G11000100071",6,58,0,0,0,0,64
"G11000100071206","G11000100071",17,103,0,0,0,11,131
"G11000100071302","G11000100071",4,51,0,5,5,4,69
"G11000100071303","G11000100071",0,204,0,0,0,7,211
"G11000100071304","G11000100071",10,256,0,0,0,1,267
"G11000100071305","G11000100071",40,200,1,0,0,25,266
"G11000100071306","G11000100071",0,73,0,0,0,0,73
"G11000100072102","G11000100072",1,6,0,0,0,0,7
"G11000100072103","G11000100072",0,15,0,0,0,0,15
"G11000100072104","G11000100072",2,71,0,0,0,0,73
"G11000100072105","G11000100072",0,1,0,0,0,0,1
"G11000100072107","G11000100072",0,12,0,0,0,0,12
"G11000100072201","G11000100072",11,293,0,0,0,0,304
"G11000100072202","G11000100072",0,1,0,0,0,0,1
"G11000100072203","G11000100072",0,0,0,0,0,0,0
"G11000100072205","G11000100072",2,50,0,0,0,0,52
"G11000100072206","G11000100072",2,168,1,0,0,0,171
"G11000100072207","G11000100072",1,273,3,1,1,0,279
"G11000100072211","G11000100072",0,73,1,0,0,0,74
"G11000100072301","G11000100072",3,25,0,0,0,0,28
"G11000100072303","G11000100072",0,1,0,0,0,0,1
"G11000100072304","G11000100072",3,10,0,0,0,0,13
"G11000100072306","G11000100072",0,66,0,0,0,0,66
"G11000100072307","G11000100072",0,0,0,0,0,0,0
"G11000100072308","G11000100072",0,110,0,0,0,0,110
"G11000100072310","G11000100072",0,2,0,0,0,0,2
"G11000100072312","G11000100072",0,64,0,0,0,0,64
"G11000100072314","G11000100072",0,51,0,0,0,0,51
"G11000100072315","G11000100072",0,16,0,0,0,0,16
"G11000100072316","G11000100072",0,90,0,0,0,0,90
"G11000100072317","G11000100072",0,66,0,0,0,0,66
"G11000100072318","G11000100072",0,33,0,0,0,0,33
"G11000100072405","G11000100072",3,7,0,0,0,0,10
"G11000100072406","G11000100072",0,0,0,0,0,0,0
"G11000100072407","G11000100072",4,39,0,0,0,1,44
"G11000100072502","G11000100072",7,10,0,0,0,0,17
"G11000100072503B","G11000100072",318,80,0,4,4,13,419
"G11000100072505","G11000100072",1,14,0,0,0,0,15
"G11000100072508","G11000100072",1,57,0,0,0,0,58
"G1100010007301104","G1100010007301",86,32,2,1,1,3,125
"G1100010007301105A","G1100010007301",8,0,0,0,0,0,8
"G1100010007301105B","G1100010007301",40,0,0,0,0,0,40
"G1100010007301105C","G1100010007301",3485,1962,29,284,284,396,6440
"G1100010007301108B","G1100010007301",14,7,0,4,4,0,29
"G1100010007301109","G1100010007301",22,22,0,5,5,14,68
"G1100010007301111","G1100010007301",10,16,0,0,0,3,29
"G1100010007301112","G1100010007301",4,21,0,0,0,0,25
"G1100010007301113","G1100010007301",30,24,0,1,1,5,61
"G1100010007301114","G1100010007301",15,22,0,0,0,8,45
"G1100010007301115","G1100010007301",2,3,0,0,0,0,5
"G1100010007301116","G1100010007301",29,24,0,0,0,4,57
"G1100010007301117","G1100010007301",9,7,0,5,5,0,26
"G1100010007301118","G1100010007301",38,34,0,0,0,10,82
"G1100010007301119","G1100010007301",7,22,0,0,0,0,29
"G1100010007301123","G1100010007301",28,4,0,5,5,3,45
"G1100010007301124","G1100010007301",14,17,0,0,0,0,31
"G1100010007301125","G1100010007301",32,22,0,0,0,4,58
"G1100010007301126","G1100010007301",20,3,0,0,0,0,23
"G1100010007301127","G1100010007301",16,13,0,2,2,6,39
"G1100010007301128","G1100010007301",13,14,0,17,17,1,62
"G1100010007301129","G1100010007301",6,21,0,0,0,2,29
"G1100010007301130","G1100010007301",109,126,1,9,9,20,274
"G1100010007301131","G1100010007301",15,9,0,4,4,9,41
"G1100010007301132","G1100010007301",21,12,0,0,0,0,33
"G1100010007301133","G1100010007301",12,17,0,2,2,0,33
"G1100010007301135","G1100010007301",37,42,0,13,13,10,115
"G1100010007301136","G1100010007301",17,17,0,5,5,9,53
"G1100010007301137","G1100010007301",23,26,0,4,4,1,58
"G1100010007301138","G1100010007301",28,32,0,8,8,1,77
"G1100010007301139","G1100010007301",20,9,0,5,5,2,41
"G1100010007301140","G1100010007301",13,23,1,10,10,4,61
"G1100010007302101","G1100010007302",3,95,0,0,0,6,104
"G1100010007302102","G1100010007302",8,118,1,0,0,0,127
"G1100010007302103","G1100010007302",13,214,0,19,19,4,269
"G1100010007302104","G1100010007302",10,197,0,0,0,0,207
"G1100010007302105","G1100010007302",2,125,0,0,0,4,131
"G1100010007302106","G1100010007302",10,228,1,0,0,0,239
"G1100010007302107","G1100010007302",8,152,0,1,1,0,162
"G1100010007302202","G1100010007302",1,21,0,0,0,0,22
"G1100010007302203","G1100010007302",1,49,0,0,0,0,50
"G1100010007302204","G1100010007302",0,23,0,0,0,0,23
"G1100010007302205","G1100010007302",0,65,0,0,0,1,66
"G1100010007302206","G1100010007302",5,90,0,0,0,0,95
"G1100010007302207","G1100010007302",6,68,0,0,0,0,74
"G1100010007302208","G1100010007302",4,78,0,0,0,0,82
"G1100010007302209","G1100010007302",0,66,0,0,0,0,66
"G1100010007302301","G1100010007302",4,0,0,0,0,0,4
"G1100010007302302","G1100010007302",0,39,0,0,0,0,39
"G1100010007302303","G1100010007302",0,30,0,0,0,0,30
"G1100010007302304","G1100010007302",0,74,0,0,0,0,74
"G1100010007302305","G1100010007302",4,128,0,0,0,1,133
"G1100010007302306","G1100010007302",3,103,0,0,0,4,110
"G1100010007302401","G1100010007302",13,445,5,0,0,2,465
"G1100010007302402","G1100010007302",11,138,0,0,0,0,149
"G1100010007302403","G1100010007302",6,143,0,0,0,0,149
"G1100010007302404","G1100010007302",4,295,0,3,3,0,305
"G1100010007302405","G1100010007302",2,47,0,0,0,0,49
"G1100010007302407","G1100010007302",0,211,0,0,0,5,216
"G1100010007302408","G1100010007302",3,193,0,2,2,0,200
"G1100010007302409","G1100010007302",4,74,0,1,1,0,80
"G1100010007302410","G1100010007302",11,332,0,0,0,4,347
"G1100010007302601","G1100010007302",1,53,0,0,0,0,54
"G1100010007302602","G1100010007302",1,74,0,0,0,0,75
"G1100010007304101","G1100010007304",0,30,0,0,0,0,30
"G1100010007304103","G1100010007304",21,535,1,0,0,2,559
"G1100010007304104","G1100010007304",3,1144,2,0,0,0,1149
"G1100010007304105","G1100010007304",1,224,1,1,1,12,240
"G1100010007304108","G1100010007304",0,137,0,2,2,1,142
"G1100010007304109","G1100010007304",0,242,0,0,0,0,242
"G1100010007304110","G1100010007304",0,126,0,0,0,0,126
"G1100010007304201","G1100010007304",1,210,0,0,0,1,212
"G1100010007304202","G1100010007304",0,55,0,0,0,0,55
"G1100010007304203","G1100010007304",1,184,3,0,0,1,189
"G1100010007304204","G1100010007304",1,146,0,0,0,0,147
"G1100010007304205","G1100010007304",0,141,1,1,1,0,144
"G1100010007304206","G1100010007304",1,107,2,0,0,0,110
"G1100010007304207","G1100010007304",3,100,0,0,0,7,110
"G1100010007304301","G1100010007304",3,99,0,0,0,1,103
"G1100010007304302","G1100010007304",0,38,0,0,0,0,38
"G1100010007304303","G1100010007304",7,45,0,0,0,0,52
"G1100010007304304","G1100010007304",5,296,0,5,5,6,317
"G1100010007304305","G1100010007304",2,49,0,0,0,0,51
"G1100010007304306","G1100010007304",0,464,0,0,0,1,465
"G1100010007308101","G1100010007308",89,610,1,1,1,7,709
"G1100010007308121","G1100010007308",1,0,0,0,0,0,1
"G1100010007401105","G1100010007401",0,20,0,0,0,0,20
"G1100010007401106","G1100010007401",0,0,0,0,0,0,0
"G1100010007401108","G1100010007401",0,68,0,0,0,0,68
"G1100010007401201","G1100010007401",4,97,0,0,0,0,101
"G1100010007401202","G1100010007401",0,155,0,0,0,0,155
"G1100010007401203","G1100010007401",0,371,2,0,0,1,374
"G1100010007401204","G1100010007401",1,141,0,0,0,0,142
"G1100010007401205","G1100010007401",4,572,0,0,0,3,579
"G1100010007401206","G1100010007401",0,488,0,0,0,0,488
"G1100010007401207","G1100010007401",0,61,0,0,0,0,61
"G1100010007401208","G1100010007401",0,61,0,2,2,0,65
"G1100010007401209","G1100010007401",2,472,0,0,0,0,474
"G1100010007401210","G1100010007401",0,47,0,0,0,0,47
"G1100010007401211","G1100010007401",0,3,0,0,0,0,3
"G1100010007401213","G1100010007401",0,108,0,0,0,0,108
"G1100010007404101","G1100010007404",7,1253,1,0,0,0,1261
"G1100010007404102","G1100010007404",0,9,0,0,0,0,9
"G1100010007404104","G1100010007404",1,323,0,0,0,0,324
"G1100010007404105","G1100010007404",0,238,0,0,0,0,238
"G1100010007404106","G1100010007404",0,288,0,0,0,0,288
"G1100010007404201","G1100010007404",0,4,0,0,0,0,4
"G1100010007404202","G1100010007404",1,95,0,0,0,1,97
"G1100010007404203","G1100010007404",2,911,2,0,0,3,918
"G1100010007404204","G1100010007404",0,147,0,0,0,0,147
"G1100010007404205","G1100010007404",0,402,0,1,1,0,404
"G1100010007404206","G1100010007404",0,149,0,0,0,0,149
"G1100010007404208","G1100010007404",0,274,2,0,0,0,276
"G1100010007406401","G1100010007406",0,210,0,0,0,0,210
"G1100010007406402","G1100010007406",2,657,1,0,0,7,667
"G1100010007406403","G1100010007406",4,1515,1,0,0,6,1526
"G1100010007407101","G1100010007407",2,444,1,0,0,0,447
"G1100010007407201","G1100010007407",0,57,0,0,0,1,58
"G1100010007407202","G1100010007407",1,70,0,0,0,8,79
"G1100010007407205","G1100010007407",0,118,0,0,0,1,119
"G1100010007407206","G1100010007407",1,23,0,0,0,0,24
"G1100010007407301","G1100010007407",1,159,0,0,0,0,160
"G1100010007407302","G1100010007407",0,25,0,0,0,0,25
"G1100010007407303","G1100010007407",0,6,0,0,0,0,6
"G1100010007407304","G1100010007407",0,25,0,0,0,0,25
"G1100010007407306","G1100010007407",0,38,0,0,0,0,38
"G1100010007407501","G1100010007407",0,123,0,0,0,0,123
"G1100010007407502","G1100010007407",0,178,0,0,0,4,182
"G1100010007407503","G1100010007407",3,337,0,0,0,1,341
"G1100010007407504","G1100010007407",0,29,0,0,0,0,29
"G1100010007407505","G1100010007407",2,662,0,4,4,4,676
"G1100010007407506","G1100010007407",1,262,1,0,0,1,265
"G1100010007407507","G1100010007407",0,118,0,0,0,0,118
"G1100010007407508","G1100010007407",0,92,0,0,0,1,93
"G1100010007407509","G1100010007407",0,338,0,0,0,2,340
"G1100010007408101","G1100010007408",0,42,0,0,0,0,42
"G1100010007408102","G1100010007408",0,300,0,0,0,0,300
"G1100010007408103","G1100010007408",0,52,0,0,0,0,52
"G1100010007408104","G1100010007408",1,46,0,0,0,0,47
"G1100010007408105","G1100010007408",0,245,0,0,0,0,245
"G1100010007408106","G1100010007408",35,1171,0,0,0,17,1223
"G1100010007408107","G1100010007408",0,240,0,0,0,9,249
"G1100010007408108","G1100010007408",0,65,0,0,0,0,65
"G1100010007408110","G1100010007408",0,37,0,0,0,0,37
"G1100010007408111","G1100010007408",4,548,0,0,0,1,553
"G1100010007408112","G1100010007408",0,255,0,0,0,1,256
"G1100010007409101","G1100010007409",1,420,0,0,0,5,426
"G1100010007409102","G1100010007409",1,279,0,0,0,0,280
"G1100010007409103","G1100010007409",2,223,0,1,1,5,232
"G1100010007409201","G1100010007409",3,536,0,9,9,1,558
"G1100010007409202","G1100010007409",0,260,0,0,0,1,261
"G1100010007409203","G1100010007409",0,48,0,0,0,0,48
"G1100010007409204","G1100010007409",4,168,0,0,0,1,173
"G1100010007409205","G1100010007409",0,160,1,0,0,0,161
"G1100010007409206","G1100010007409",0,316,0,3,3,0,322
"G1100010007409207","G1100010007409",2,307,0,0,0,1,310
"G1100010007409208","G1100010007409",0,181,0,0,0,3,184
"G1100010007409209","G1100010007409",0,37,0,0,0,0,37
"G1100010007430103","G1100010007430",3,1314,1,1,1,8,1328
"G1100010007430104","G1100010007430",1,202,0,1,1,0,205
"G1100010007430105","G1100010007430",0,593,0,0,0,1,594
"G1100010007430106","G1100010007430",1,201,0,0,0,5,207
"G1100010007430107","G1100010007430",0,113,0,3,3,1,120
"G1100010007502101","G1100010007502",25,1046,1,1,1,4,1078
"G1100010007502102","G1100010007502",3,147,0,0,0,0,150
"G1100010007502103","G1100010007502",2,161,0,0,0,0,163
"G1100010007502104","G1100010007502",0,44,0,1,1,0,46
"G1100010007502106","G1100010007502",0,720,1,0,0,1,722
"G1100010007502201","G1100010007502",11,495,0,0,0,1,507
"G1100010007502203","G1100010007502",2,125,3,0,0,0,130
"G1100010007502204","G1100010007502",0,1,0,0,0,0,1
"G1100010007502206","G1100010007502",2,173,0,0,0,0,175
"G1100010007502207","G1100010007502",4,622,1,1,1,5,634
"G1100010007502301","G1100010007502",0,51,0,0,0,0,51
"G1100010007502302","G1100010007502",20,476,0,0,0,21,517
"G1100010007502303","G1100010007502",0,60,0,0,0,0,60
"G1100010007502304","G1100010007502",11,137,5,0,0,8,161
"G1100010007503201","G1100010007503",6,841,0,0,0,7,854
"G1100010007503202","G1100010007503",14,201,0,0,0,1,216
"G1100010007503203","G1100010007503",5,338,0,1,1,9,354
"G1100010007503204","G1100010007503",3,560,0,15,15,1,594
"G1100010007503205","G1100010007503",0,43,0,0,0,0,43
"G1100010007503301","G1100010007503",0,10,0,0,0,0,10
"G1100010007503302","G1100010007503",6,40,0,0,0,1,47
"G1100010007503303","G1100010007503",11,101,0,2,2,0,116
"G1100010007503304","G1100010007503",3,78,0,0,0,0,81
"G1100010007503305","G1100010007503",0,89,0,0,0,0,89
"G1100010007503306","G1100010007503",1,119,0,0,0,2,122
"G1100010007503307","G1100010007503",13,80,0,0,0,0,93
"G1100010007503308","G1100010007503",2,53,0,0,0,0,55
"G1100010007503401","G1100010007503",7,54,0,5,5,0,71
"G1100010007503403","G1100010007503",4,67,0,0,0,1,72
"G1100010007503404","G1100010007503",1,39,0,0,0,0,40
"G1100010007503406","G1100010007503",0,22,0,0,0,0,22
"G1100010007503407","G1100010007503",0,46,0,0,0,0,46
"G1100010007503408","G1100010007503",3,12,0,0,0,2,17
"G1100010007503409","G1100010007503",3,94,0,0,0,0,97
"G1100010007504101","G1100010007504",8,1417,1,4,4,13,1447
"G1100010007504102","G1100010007504",0,18,0,0,0,0,18
"G1100010007504103","G1100010007504",33,152,0,1,1,0,187
"G1100010007504104","G1100010007504",2,120,0,0,0,0,122
"G1100010007504105","G1100010007504",0,300,0,0,0,1,301
"G1100010007504106","G1100010007504",25,28,1,1,1,0,56
"G1100010007504201","G1100010007504",0,176,0,0,0,0,176
"G1100010007504202","G1100010007504",0,221,0,0,0,0,221
"G1100010007504203","G1100010007504",0,33,0,0,0,0,33
"G1100010007504301","G1100010007504",11,102,0,3,3,0,119
"G1100010007601101","G1100010007601",4,20,0,0,0,1,25
"G1100010007601103","G1100010007601",5,50,0,0,0,0,55
"G1100010007601104","G1100010007601",1,66,0,0,0,0,67
"G1100010007601105","G1100010007601",2,66,0,0,0,0,68
"G1100010007601106","G1100010007601",20,75,0,2,2,0,99
"G1100010007601107","G1100010007601",2,298,0,0,0,2,302
"G1100010007601201","G1100010007601",3,64,0,0,0,0,67
"G1100010007601202","G1100010007601",14,59,0,0,0,4,77
"G1100010007601203","G1100010007601",2,77,1,0,0,0,80
"G1100010007601204","G1100010007601",1,109,0,1,1,0,112
"G1100010007601205","G1100010007601",2,108,0,0,0,0,110
"G1100010007601206","G1100010007601",17,70,0,0,0,0,87
"G1100010007601208","G1100010007601",2,110,0,0,0,0,112
"G1100010007601210","G1100010007601",3,8,1,0,0,0,12
"G1100010007601211","G1100010007601",4,13,0,0,0,0,17
"G1100010007601220","G1100010007601",0,44,1,0,0,0,45
"G1100010007601301","G1100010007601",3,83,0,0,0,0,86
"G1100010007601302","G1100010007601",21,152,3,0,0,1,177
"G1100010007601303","G1100010007601",3,75,0,0,0,0,78
"G1100010007601304","G1100010007601",2,79,0,0,0,0,81
"G1100010007601305","G1100010007601",8,147,0,0,0,1,156
"G1100010007601306","G1100010007601",0,43,0,0,0,0,43
"G1100010007601307","G1100010007601",5,79,0,0,0,0,84
"G1100010007601401","G1100010007601",15,147,2,2,2,1,169
"G1100010007601402","G1100010007601",1,210,0,0,0,0,211
"G1100010007601403","G1100010007601",0,108,0,0,0,0,108
"G1100010007601404","G1100010007601",2,220,0,0,0,15,237
"G1100010007601405","G1100010007601",1,151,1,4,4,2,163
"G1100010007601406","G1100010007601",9,153,0,0,0,1,163
"G1100010007601407","G1100010007601",0,43,0,0,0,5,48
"G1100010007601408","G1100010007601",6,79,0,0,0,0,85
"G1100010007601409","G1100010007601",3,15,0,0,0,0,18
"G1100010007601410","G1100010007601",3,211,0,4,4,0,222
"G1100010007601411","G1100010007601",2,42,0,0,0,0,44
"G1100010007601412","G1100010007601",0,10,0,0,0,0,10
"G1100010007601413","G1100010007601",3,381,1,2,2,3,392
"G1100010007601414","G1100010007601",2,81,0,0,0,0,83
"G1100010007601415","G1100010007601",5,34,0,0,0,0,39
"G1100010007601416","G1100010007601",2,194,0,0,0,2,198
"G1100010007601501","G1100010007601",7,166,0,1,1,0,175
"G1100010007601502","G1100010007601",2,218,1,0,0,0,221
"G1100010007601503","G1100010007601",0,120,0,0,0,0,120
"G1100010007601504","G1100010007601",10,124,0,0,0,0,134
"G1100010007601505","G1100010007601",0,205,0,0,0,0,205
"G1100010007601506","G1100010007601",9,79,0,0,0,0,88
"G1100010007601507","G1100010007601",4,58,0,0,0,0,62
"G1100010007601509","G1100010007601",0,0,0,0,0,0,0
"G1100010007603101","G1100010007603",2,108,3,0,0,4,117
"G1100010007603102","G1100010007603",15,280,0,1,1,2,299
"G1100010007603103","G1100010007603",3,118,0,0,0,5,126
"G1100010007603104","G1100010007603",4,214,0,2,2,2,224
"G1100010007603105","G1100010007603",10,622,0,4,4,11,651
"G1100010007603106","G1100010007603",2,184,0,0,0,2,188
"G1100010007603201","G1100010007603",11,81,0,0,0,4,96
"G1100010007603202","G1100010007603",20,106,0,0,0,2,128
"G1100010007603203","G1100010007603",4,49,0,0,0,0,53
"G1100010007603204","G1100010007603",6,69,0,0,0,0,75
"G1100010007603205","G1100010007603",24,47,0,1,1,1,74
"G1100010007603206","G1100010007603",0,26,0,0,0,4,30
"G1100010007603208","G1100010007603",13,23,1,1,1,4,43
"G1100010007603209","G1100010007603",4,32,0,0,0,0,36
"G1100010007603301","G1100010007603",10,47,0,0,0,0,57
"G1100010007603302","G1100010007603",8,73,0,0,0,0,81
"G1100010007603303","G1100010007603",9,61,0,0,0,6,76
"G1100010007603306","G1100010007603",8,54,0,0,0,0,62
"G1100010007603307","G1100010007603",0,4,0,0,0,0,4
"G1100010007603401","G1100010007603",6,20,0,0,0,0,26
"G1100010007603402","G1100010007603",7,12,0,0,0,0,19
"G1100010007603403","G1100010007603",5,13,0,0,0,0,18
"G1100010007603404","G1100010007603",3,17,0,0,0,0,20
"G1100010007603405","G1100010007603",8,29,0,0,0,3,40
"G1100010007603406","G1100010007603",103,105,0,3,3,3,217
"G1100010007603407","G1100010007603",125,205,0,0,0,24,354
"G1100010007603408","G1100010007603",120,152,0,1,1,11,285
"G1100010007603409","G1100010007603",88,169,0,5,5,10,277
"G1100010007603501","G1100010007603",31,164,0,0,0,6,201
"G1100010007603502","G1100010007603",0,70,0,0,0,0,70
"G1100010007603503","G1100010007603",5,107,0,0,0,2,114
"G1100010007603504","G1100010007603",24,43,0,11,11,8,97
"G1100010007603505","G1100010007603",4,27,0,0,0,0,31
"G1100010007603506","G1100010007603",7,73,0,6,6,0,92
"G1100010007603507","G1100010007603",7,40,0,1,1,2,51
"G1100010007603508","G1100010007603",9,17,0,0,0,0,26
"G1100010007603509","G1100010007603",18,14,0,0,0,0,32
"G1100010007603510","G1100010007603",9,31,0,0,0,0,40
"G1100010007603511","G1100010007603",7,25,0,0,0,0,32
"G1100010007603512","G1100010007603",10,24,0,0,0,0,34
"G1100010007604101","G1100010007604",2,72,0,2,2,1,79
"G1100010007604102","G1100010007604",1,184,0,0,0,0,185
"G1100010007604103","G1100010007604",3,178,0,1,1,18,201
"G1100010007604104","G1100010007604",3,126,2,0,0,0,131
"G1100010007604105","G1100010007604",10,147,0,0,0,7,164
"G1100010007604106","G1100010007604",2,179,0,0,0,0,181
"G1100010007604107","G1100010007604",1,263,1,0,0,0,265
"G1100010007604201","G1100010007604",4,229,3,2,2,1,241
"G1100010007604202","G1100010007604",0,63,0,0,0,0,63
"G1100010007604203","G1100010007604",0,76,0,0,0,4,80
"G1100010007604204","G1100010007604",0,77,0,0,0,5,82
"G1100010007604205","G1100010007604",0,67,0,1,1,0,69
"G1100010007604207","G1100010007604",0,93,0,0,0,0,93
"G1100010007604208","G1100010007604",3,120,0,0,0,0,123
"G1100010007604209","G1100010007604",5,94,0,0,0,1,100
"G1100010007604210","G1100010007604",23,110,0,0,0,2,135
"G1100010007604302","G1100010007604",0,73,0,0,0,1,74
"G1100010007604303","G1100010007604",11,62,0,0,0,0,73
"G1100010007604320","G1100010007604",22,203,0,0,0,4,229
"G1100010007604402","G1100010007604",3,39,0,0,0,0,42
"G1100010007604403","G1100010007604",6,17,0,0,0,0,23
"G1100010007604405","G1100010007604",0,3,0,0,0,0,3
"G1100010007604406","G1100010007604",9,44,0,0,0,0,53
"G1100010007604407","G1100010007604",8,90,0,6,6,0,110
"G1100010007604408","G1100010007604",12,83,0,0,0,0,95
"G1100010007604501","G1100010007604",5,69,0,0,0,0,74
"G1100010007604502","G1100010007604",13,22,0,0,0,0,35
"G1100010007604503","G1100010007604",5,41,0,0,0,0,46
"G1100010007604504","G1100010007604",14,98,0,0,0,2,114
"G1100010007604505","G1100010007604",4,9,0,0,0,0,13
"G1100010007604506","G1100010007604",1,20,0,0,0,0,21
"G1100010007604507","G1100010007604",0,6,0,0,0,0,6
"G1100010007604508","G1100010007604",2,10,0,0,0,0,12
"G1100010007604601","G1100010007604",7,43,0,0,0,6,56
"G1100010007604602","G1100010007604",6,56,0,0,0,0,62
"G1100010007604603","G1100010007604",4,48,0,0,0,0,52
"G1100010007604604","G1100010007604",3,57,0,0,0,0,60
"G1100010007604605","G1100010007604",1,18,0,0,0,0,19
"G1100010007604606","G1100010007604",2,28,0,0,0,1,31
"G1100010007604607","G1100010007604",2,33,0,0,0,0,35
"G1100010007604608","G1100010007604",8,27,1,0,0,0,36
"G1100010007604609","G1100010007604",10,84,0,0,0,0,94
"G1100010007604610","G1100010007604",18,615,1,0,0,4,638
"G1100010007605701","G1100010007605",8,328,1,0,0,0,337
"G1100010007605702","G1100010007605",15,1735,1,7,7,4,1769
"G1100010007605703","G1100010007605",4,83,1,0,0,0,88
"G1100010007605704","G1100010007605",6,245,0,0,0,0,251
"G1100010007605705","G1100010007605",4,67,0,0,0,0,71
"G1100010007605706","G1100010007605",8,208,0,0,0,1,217
"G1100010007605707","G1100010007605",5,55,0,0,0,0,60
"G1100010007605708","G1100010007605",6,62,0,0,0,0,68
"G1100010007605709","G1100010007605",0,155,0,0,0,2,157
"G1100010007605710","G1100010007605",7,108,0,0,0,0,115
"G1100010007605711","G1100010007605",1,235,0,0,0,12,248
"G1100010007605712","G1100010007605",4,264,0,0,0,0,268
"G1100010007605714","G1100010007605",2,107,0,0,0,0,109
"G1100010007605716","G1100010007605",2,122,1,0,0,0,125
"G1100010007703102","G1100010007703",0,274,0,0,0,6,280
"G1100010007703103","G1100010007703",1,233,3,0,0,0,237
"G1100010007703104","G1100010007703",1,41,0,0,0,0,42
"G1100010007703105","G1100010007703",1,165,0,0,0,0,166
"G1100010007703107","G1100010007703",3,116,0,0,0,39,158
"G1100010007703108","G1100010007703",0,163,0,0,0,0,163
"G1100010007703201","G1100010007703",0,192,0,0,0,1,193
"G1100010007703202","G1100010007703",1,244,0,0,0,4,249
"G1100010007703203","G1100010007703",2,170,0,0,0,0,172
"G1100010007703204","G1100010007703",0,99,0,0,0,1,100
"G1100010007703206","G1100010007703",3,411,1,0,0,9,424
"G1100010007703301","G1100010007703",1,293,0,0,0,3,297
"G1100010007703302","G1100010007703",1,127,0,0,0,1,129
"G1100010007703303","G1100010007703",8,1181,2,0,0,15,1206
"G1100010007703304","G1100010007703",15,332,3,0,0,1,351
"G1100010007703305","G1100010007703",4,852,0,4,4,2,866
"G1100010007703306","G1100010007703",0,72,0,0,0,0,72
"G1100010007703320","G1100010007703",0,560,2,0,0,1,563
"G1100010007707104","G1100010007707",1,207,0,0,0,0,208
"G1100010007707105","G1100010007707",0,158,0,0,0,0,158
"G1100010007707106","G1100010007707",2,59,0,0,0,1,62
"G1100010007707107","G1100010007707",0,6,0,0,0,0,6
"G1100010007707111","G1100010007707",4,187,0,5,5,4,205
"G1100010007707112","G1100010007707",0,416,0,0,0,0,416
"G1100010007707113","G1100010007707",0,39,0,0,0,0,39
"G1100010007707114","G1100010007707",0,18,0,0,0,0,18
"G1100010007707115","G1100010007707",2,93,0,0,0,0,95
"G1100010007707120","G1100010007707",0,1049,0,0,0,5,1054
"G1100010007707121","G1100010007707",0,117,0,0,0,0,117
"G1100010007707201","G1100010007707",0,96,0,0,0,0,96
"G1100010007707202","G1100010007707",1,12,0,0,0,0,13
"G1100010007707203","G1100010007707",0,66,0,0,0,0,66
"G1100010007707204","G1100010007707",4,103,0,0,0,1,108
"G1100010007707205","G1100010007707",3,91,0,0,0,0,94
"G1100010007707206","G1100010007707",1,68,0,0,0,0,69
"G1100010007707207","G1100010007707",2,53,0,0,0,0,55
"G1100010007707208","G1100010007707",1,70,0,0,0,0,71
"G1100010007707209","G1100010007707",0,37,0,0,0,0,37
"G1100010007707210","G1100010007707",1,45,0,0,0,0,46
"G1100010007707211","G1100010007707",0,15,0,0,0,3,18
"G1100010007707213","G1100010007707",0,39,1,0,0,0,40
"G1100010007707301","G1100010007707",2,118,0,0,0,1,121
"G1100010007707302","G1100010007707",0,32,0,0,0,0,32
"G1100010007707303","G1100010007707",0,89,0,0,0,0,89
"G1100010007707304","G1100010007707",1,79,0,0,0,0,80
"G1100010007707305","G1100010007707",2,232,0,1,1,2,238
"G1100010007707306","G1100010007707",0,111,0,0,0,0,111
"G1100010007707307","G1100010007707",0,79,0,0,0,0,79
"G1100010007707308","G1100010007707",0,24,0,0,0,0,24
"G1100010007707309","G1100010007707",5,18,0,0,0,0,23
"G1100010007707310","G1100010007707",0,85,1,0,0,0,86
"G1100010007707311","G1100010007707",6,100,0,0,0,1,107
"G1100010007707312","G1100010007707",0,73,0,0,0,0,73
"G1100010007707313","G1100010007707",0,43,0,0,0,0,43
"G1100010007708101","G1100010007708",2,132,1,0,0,0,135
"G1100010007708102","G1100010007708",0,16,0,0,0,0,16
"G1100010007708103","G1100010007708",1,274,0,0,0,0,275
"G1100010007708104","G1100010007708",5,278,1,0,0,0,284
"G1100010007708105","G1100010007708",0,58,0,0,0,0,58
"G1100010007708106","G1100010007708",0,117,0,0,0,0,117
"G1100010007708107","G1100010007708",0,264,0,0,0,0,264
"G1100010007708108","G1100010007708",2,187,0,0,0,0,189
"G1100010007708201","G1100010007708",6,253,1,0,0,4,264
"G1100010007708202","G1100010007708",0,163,1,0,0,4,168
"G1100010007708203","G1100010007708",0,123,1,0,0,3,127
"G1100010007708204","G1100010007708",0,176,0,0,0,0,176
"G1100010007708205","G1100010007708",0,150,0,0,0,0,150
"G1100010007708206","G1100010007708",1,75,0,0,0,0,76
"G1100010007708207","G1100010007708",2,89,0,0,0,0,91
"G1100010007708208","G1100010007708",0,93,0,0,0,0,93
"G1100010007708209","G1100010007708",1,132,1,0,0,0,134
"G1100010007708210","G1100010007708",0,57,0,0,0,0,57
"G1100010007708211","G1100010007708",5,99,0,1,1,1,107
"G1100010007708212","G1100010007708",0,31,0,0,0,0,31
"G1100010007708213","G1100010007708",1,34,0,0,0,0,35
"G1100010007708214","G1100010007708",1,44,0,0,0,0,45
"G1100010007709301","G1100010007709",4,135,0,0,0,13,152
"G1100010007709304","G1100010007709",1,108,0,0,0,0,109
"G1100010007709309","G1100010007709",2,66,0,0,0,0,68
"G1100010007709310","G1100010007709",4,102,0,0,0,0,106
"G1100010007709317","G1100010007709",3,28,0,2,2,0,35
"G1100010007709318","G1100010007709",4,51,0,0,0,0,55
"G1100010007709401","G1100010007709",0,13,0,0,0,0,13
"G1100010007709402","G1100010007709",1,97,0,0,0,0,98
"G1100010007709403","G1100010007709",1,83,0,0,0,0,84
"G1100010007709405","G1100010007709",0,63,0,0,0,0,63
"G1100010007709406","G1100010007709",2,92,1,0,0,0,95
"G1100010007709407","G1100010007709",6,263,0,0,0,0,269
"G1100010007709408","G1100010007709",15,194,0,0,0,3,212
"G1100010007709409","G1100010007709",2,126,0,1,1,6,136
"G1100010007709410","G1100010007709",5,95,0,0,0,0,100
"G1100010007709501","G1100010007709",0,18,0,0,0,0,18
"G1100010007709503","G1100010007709",6,102,2,0,0,5,115
"G1100010007709504","G1100010007709",12,149,0,0,0,0,161
"G1100010007709505","G1100010007709",0,69,0,0,0,0,69
"G1100010007709506","G1100010007709",10,38,0,0,0,10,58
"G1100010007709508","G1100010007709",1,22,0,0,0,0,23
"G1100010007709509","G1100010007709",1,49,0,2,2,0,54
"G1100010007709510","G1100010007709",8,83,0,0,0,1,92
"G1100010007709511","G1100010007709",2,55,0,0,0,0,57
"G1100010007709512","G1100010007709",7,85,0,0,0,3,95
"G1100010007709513","G1100010007709",0,6,0,0,0,0,6
"G1100010007803102","G1100010007803",0,19,0,0,0,0,19
"G1100010007803103","G1100010007803",0,108,0,0,0,0,108
"G1100010007803104","G1100010007803",0,79,0,0,0,0,79
"G1100010007803105","G1100010007803",0,117,0,0,0,1,118
"G1100010007803107","G1100010007803",1,92,2,0,0,0,95
"G1100010007803108","G1100010007803",0,48,0,0,0,0,48
"G1100010007803110","G1100010007803",0,6,0,0,0,0,6
"G1100010007803111","G1100010007803",0,72,0,0,0,0,72
"G1100010007803201","G1100010007803",1,91,0,0,0,0,92
"G1100010007803202","G1100010007803",0,61,0,0,0,0,61
"G1100010007803203","G1100010007803",0,73,0,0,0,0,73
"G1100010007803204","G1100010007803",0,139,0,0,0,0,139
"G1100010007803205","G1100010007803",1,80,0,1,1,1,84
"G1100010007803206","G1100010007803",0,150,0,0,0,1,151
"G1100010007803207","G1100010007803",0,104,0,0,0,0,104
"G1100010007803208","G1100010007803",1,45,0,0,0,0,46
"G1100010007803301","G1100010007803",0,207,0,0,0,0,207
"G1100010007803302","G1100010007803",0,92,0,0,0,0,92
"G1100010007803303","G1100010007803",0,34,0,0,0,0,34
"G1100010007803304","G1100010007803",0,32,0,0,0,0,32
"G1100010007803305","G1100010007803",0,31,0,0,0,0,31
"G1100010007803306","G1100010007803",0,22,0,0,0,0,22
"G1100010007803307","G1100010007803",0,89,0,1,1,0,91
"G1100010007803308","G1100010007803",0,45,0,0,0,0,45
"G1100010007803309","G1100010007803",1,82,0,0,0,0,83
"G1100010007803310","G1100010007803",0,44,0,0,0,0,44
"G1100010007803311","G1100010007803",0,3,0,0,0,0,3
"G1100010007803321","G1100010007803",1,34,0,0,0,1,36
"G1100010007803401","G1100010007803",4,582,1,0,0,2,589
"G1100010007803402","G1100010007803",0,89,0,0,0,1,90
"G1100010007803403","G1100010007803",0,158,0,0,0,0,158
"G1100010007803404","G1100010007803",3,132,0,0,0,0,135
"G1100010007803405","G1100010007803",0,215,0,0,0,1,216
"G1100010007803406","G1100010007803",0,173,0,2,2,0,177
"G1100010007803407","G1100010007803",0,193,1,0,0,0,194
"G1100010007803501","G1100010007803",2,197,3,0,0,0,202
"G1100010007803502","G1100010007803",0,4,0,0,0,0,4
"G1100010007803503","G1100010007803",0,138,0,0,0,1,139
"G1100010007803506","G1100010007803",0,114,0,0,0,9,123
"G1100010007803508","G1100010007803",0,36,0,0,0,0,36
"G1100010007804101","G1100010007804",22,283,0,1,1,0,307
"G1100010007804102","G1100010007804",0,6,1,0,0,0,7
"G1100010007804103","G1100010007804",0,50,1,0,0,0,51
"G1100010007804104","G1100010007804",0,50,0,0,0,0,50
"G1100010007804105","G1100010007804",0,48,1,1,1,0,51
"G1100010007804106","G1100010007804",0,6,0,0,0,0,6
"G1100010007804107","G1100010007804",0,50,0,0,0,1,51
"G1100010007804201","G1100010007804",0,274,0,0,0,0,274
"G1100010007804202","G1100010007804",1,369,0,0,0,3,373
"G1100010007804203","G1100010007804",1,7,0,0,0,0,8
"G1100010007804204","G1100010007804",0,328,0,0,0,0,328
"G1100010007804205","G1100010007804",0,204,0,0,0,0,204
"G1100010007804206","G1100010007804",0,233,0,0,0,0,233
"G1100010007804207","G1100010007804",0,179,0,0,0,0,179
"G1100010007804208","G1100010007804",1,54,0,0,0,0,55
"G1100010007804209","G1100010007804",0,58,0,0,0,0,58
"G1100010007804210","G1100010007804",0,85,2,0,0,12,99
"G1100010007804211","G1100010007804",1,94,0,0,0,0,95
"G1100010007804301","G1100010007804",0,4,0,0,0,0,4
"G1100010007804302","G1100010007804",0,13,0,0,0,0,13
"G1100010007804303","G1100010007804",0,5,0,0,0,0,5
"G1100010007804304","G1100010007804",0,50,0,0,0,0,50
"G1100010007804305","G1100010007804",1,80,0,0,0,0,81
"G1100010007804306","G1100010007804",0,43,0,0,0,0,43
"G1100010007804307","G1100010007804",3,26,0,0,0,0,29
"G1100010007804308","G1100010007804",0,14,0,0,0,0,14
"G1100010007804401","G1100010007804",0,40,0,0,0,0,40
"G1100010007804402","G1100010007804",1,73,0,0,0,0,74
"G1100010007804403","G1100010007804",0,84,0,0,0,0,84
"G1100010007804404","G1100010007804",0,48,2,0,0,0,50
"G1100010007804405","G1100010007804",0,17,0,0,0,0,17
"G1100010007804406","G1100010007804",0,45,0,1,1,0,47
"G1100010007804407","G1100010007804",0,90,0,0,0,0,90
"G1100010007804408","G1100010007804",0,46,0,0,0,0,46
"G1100010007804409","G1100010007804",0,37,0,0,0,0,37
"G1100010007804410","G1100010007804",0,58,0,0,0,0,58
"G1100010007804501","G1100010007804",0,81,0,0,0,0,81
"G1100010007804503","G1100010007804",1,130,4,0,0,1,136
"G1100010007804504","G1100010007804",0,26,0,0,0,0,26
"G1100010007804505","G1100010007804",2,164,0,0,0,0,166
"G1100010007804508","G1100010007804",0,5,0,0,0,0,5
"G1100010007807104","G1100010007807",2,184,1,0,0,0,187
"G1100010007807107","G1100010007807",1,97,0,2,2,0,102
"G1100010007807111","G1100010007807",0,119,3,0,0,12,134
"G1100010007807112","G1100010007807",0,90,0,0,0,3,93
"G1100010007807120","G1100010007807",0,12,0,0,0,0,12
"G1100010007807121","G1100010007807",0,25,0,0,0,0,25
"G1100010007807201","G1100010007807",3,54,0,0,0,1,58
"G1100010007807202","G1100010007807",0,93,0,0,0,0,93
"G1100010007807203","G1100010007807",1,101,0,0,0,0,102
"G1100010007807204","G1100010007807",0,55,0,0,0,0,55
"G1100010007807205","G1100010007807",3,177,2,0,0,0,182
"G1100010007807207","G1100010007807",0,53,0,0,0,0,53
"G1100010007807208","G1100010007807",0,67,0,0,0,0,67
"G1100010007807301","G1100010007807",1,38,0,0,0,0,39
"G1100010007807302","G1100010007807",1,102,0,0,0,0,103
"G1100010007807401","G1100010007807",2,80,0,0,0,0,82
"G1100010007807402","G1100010007807",0,8,0,0,0,0,8
"G1100010007807403","G1100010007807",0,79,0,0,0,6,85
"G1100010007807404","G1100010007807",0,32,0,0,0,0,32
"G1100010007807405","G1100010007807",0,96,0,0,0,0,96
"G1100010007807407","G1100010007807",0,114,0,0,0,0,114
"G1100010007807408","G1100010007807",0,474,4,0,0,13,491
"G1100010007808101","G1100010007808",0,8,0,2,2,0,12
"G1100010007808102","G1100010007808",0,147,0,0,0,1,148
"G1100010007808103","G1100010007808",0,80,0,0,0,0,80
"G1100010007808104","G1100010007808",0,97,1,0,0,4,102
"G1100010007808106","G1100010007808",1,121,0,0,0,0,122
"G1100010007808107","G1100010007808",0,65,0,0,0,0,65
"G1100010007808108","G1100010007808",1,31,0,0,0,0,32
"G1100010007808201","G1100010007808",0,24,0,0,0,0,24
"G1100010007808202","G1100010007808",0,82,0,0,0,0,82
"G1100010007808203","G1100010007808",0,83,0,0,0,0,83
"G1100010007808204","G1100010007808",1,94,0,0,0,0,95
"G1100010007808205","G1100010007808",2,41,0,0,0,1,44
"G1100010007808206","G1100010007808",0,30,0,0,0,0,30
"G1100010007808207","G1100010007808",0,64,0,0,0,0,64
"G1100010007808208","G1100010007808",0,57,0,0,0,4,61
"G1100010007808209","G1100010007808",1,464,0,5,5,3,478
"G1100010007808210","G1100010007808",0,406,2,0,0,0,408
"G1100010007808301","G1100010007808",0,24,0,0,0,0,24
"G1100010007808302","G1100010007808",1,52,0,0,0,0,53
"G1100010007808303","G1100010007808",0,13,0,0,0,0,13
"G1100010007808304","G1100010007808",0,38,0,2,2,0,42
"G1100010007808305","G1100010007808",2,349,3,0,0,0,354
"G1100010007808307","G1100010007808",0,108,0,0,0,7,115
"G1100010007808308","G1100010007808",0,87,0,0,0,0,87
"G1100010007808309","G1100010007808",0,142,0,1,1,1,145
"G1100010007808310","G1100010007808",0,157,0,0,0,4,161
"G1100010007808311","G1100010007808",0,74,0,0,0,0,74
"G1100010007808401","G1100010007808",0,161,0,0,0,0,161
"G1100010007808402","G1100010007808",1,167,1,0,0,0,169
"G1100010007808403","G1100010007808",0,97,0,0,0,0,97
"G1100010007808404","G1100010007808",0,153,0,0,0,0,153
"G1100010007808405","G1100010007808",2,485,0,0,0,1,488
"G1100010007808406","G1100010007808",0,106,0,0,0,1,107
"G1100010007808407","G1100010007808",0,2,0,0,0,0,2
"G1100010007808409","G1100010007808",0,84,0,0,0,0,84
"G1100010007808502","G1100010007808",0,43,0,0,0,0,43
"G1100010007808503","G1100010007808",1,132,0,0,0,0,133
"G1100010007808504","G1100010007808",0,93,0,0,0,0,93
"G1100010007808505","G1100010007808",0,106,2,0,0,0,108
"G1100010007808506","G1100010007808",0,84,1,0,0,0,85
"G1100010007808507","G1100010007808",0,49,0,0,0,0,49
"G1100010007809301","G1100010007809",0,86,0,0,0,0,86
"G1100010007809302","G1100010007809",0,309,0,0,0,0,309
"G1100010007809303","G1100010007809",2,236,0,0,0,4,242
"G1100010007809304","G1100010007809",0,99,0,0,0,0,99
"G1100010007809305","G1100010007809",2,178,0,0,0,0,180
"G1100010007809306","G1100010007809",0,182,0,0,0,0,182
"G1100010007809307","G1100010007809",0,159,0,0,0,0,159
"G1100010007809308","G1100010007809",2,530,1,1,1,0,535
"G1100010007809401","G1100010007809",1,71,0,0,0,0,72
"G1100010007809402","G1100010007809",0,87,0,0,0,0,87
"G1100010007809403","G1100010007809",0,52,0,0,0,0,52
"G1100010007809404","G1100010007809",0,65,0,0,0,0,65
"G1100010007809405","G1100010007809",0,65,0,0,0,0,65
"G1100010007809406","G1100010007809",0,116,0,0,0,0,116
"G1100010007809407","G1100010007809",1,80,0,0,0,2,83
"G1100010007809408","G1100010007809",1,75,0,0,0,0,76
"G1100010007809409","G1100010007809",0,153,0,0,0,0,153
"G1100010007809701","G1100010007809",0,39,0,0,0,0,39
"G1100010007809702","G1100010007809",0,48,0,0,0,2,50
"G1100010007809703","G1100010007809",2,28,1,0,0,0,31
"G1100010007809704","G1100010007809",0,21,0,0,0,0,21
"G1100010007809705","G1100010007809",0,77,0,0,0,0,77
"G1100010007809706","G1100010007809",0,23,0,0,0,0,23
"G1100010007860101","G1100010007860",0,48,0,0,0,0,48
"G1100010007860102","G1100010007860",0,151,0,0,0,0,151
"G1100010007860103","G1100010007860",0,263,3,0,0,0,266
"G1100010007860104","G1100010007860",7,66,1,0,0,0,74
"G1100010007860105","G1100010007860",0,124,0,0,0,1,125
"G1100010007860106","G1100010007860",0,62,0,0,0,0,62
"G1100010007860107","G1100010007860",0,41,0,0,0,0,41
"G1100010007860108","G1100010007860",0,82,0,0,0,0,82
"G1100010007860201","G1100010007860",0,80,0,0,0,0,80
"G1100010007860202","G1100010007860",0,65,0,0,0,1,66
"G1100010007860203","G1100010007860",0,28,4,0,0,0,32
"G1100010007860204","G1100010007860",0,53,0,0,0,0,53
"G1100010007860205","G1100010007860",0,15,0,0,0,0,15
"G1100010007860206","G1100010007860",0,58,0,0,0,0,58
"G1100010007860207","G1100010007860",0,23,0,0,0,0,23
"G1100010007860208","G1100010007860",0,38,0,0,0,0,38
"G1100010007860209","G1100010007860",0,84,0,0,0,0,84
"G1100010007860210","G1100010007860",0,88,0,0,0,0,88
"G1100010007860501","G1100010007860",0,36,0,4,4,0,44
"G1100010007860502","G1100010007860",2,54,0,0,0,0,56
"G1100010007860503","G1100010007860",0,63,0,0,0,1,64
"G1100010007860504","G1100010007860",0,48,0,0,0,0,48
"G1100010007860505","G1100010007860",1,37,0,0,0,0,38
"G1100010007860506","G1100010007860",0,44,0,0,0,0,44
"G1100010007860507","G1100010007860",0,39,0,0,0,0,39
"G1100010007860508","G1100010007860",0,91,0,0,0,9,100
"G1100010007860509","G1100010007860",0,58,0,0,0,0,58
"G1100010007860510","G1100010007860",0,56,0,0,0,0,56
"G1100010007860601","G1100010007860",0,125,0,0,0,0,125
"G1100010007860602","G1100010007860",0,31,0,0,0,0,31
"G1100010007860603","G1100010007860",0,35,0,0,0,0,35
"G1100010007860605","G1100010007860",0,34,0,0,0,0,34
"G1100010007860606","G1100010007860",5,55,2,0,0,0,62
"G1100010007860608","G1100010007860",2,47,0,0,0,0,49
"G1100010007860609","G1100010007860",0,16,0,0,0,0,16
"G1100010007860610","G1100010007860",1,100,0,0,0,0,101
"G1100010007901101","G1100010007901",1,44,0,0,0,0,45
"G1100010007901102","G1100010007901",0,215,0,0,0,3,218
"G1100010007901103","G1100010007901",0,140,0,0,0,0,140
"G1100010007901105","G1100010007901",4,100,0,0,0,4,108
"G1100010007901106","G1100010007901",2,91,0,0,0,0,93
"G1100010007901201","G1100010007901",0,147,0,0,0,0,147
"G1100010007901202","G1100010007901",1,194,0,0,0,0,195
"G1100010007901203","G1100010007901",0,170,0,0,0,0,170
"G1100010007901204","G1100010007901",2,178,0,0,0,7,187
"G1100010007901205","G1100010007901",3,118,0,1,1,0,123
"G1100010007901206","G1100010007901",4,118,1,0,0,1,124
"G1100010007901301","G1100010007901",4,196,0,1,1,1,203
"G1100010007901302","G1100010007901",7,138,0,3,3,0,151
"G1100010007901303","G1100010007901",0,117,0,0,0,0,117
"G1100010007901304","G1100010007901",0,104,0,0,0,0,104
"G1100010007901305","G1100010007901",0,161,0,0,0,0,161
"G1100010007901306","G1100010007901",9,215,0,0,0,3,227
"G1100010007901307","G1100010007901",4,144,0,0,0,1,149
"G1100010007901401","G1100010007901",6,122,0,0,0,0,128
"G1100010007901402","G1100010007901",1,133,0,0,0,0,134
"G1100010007901403","G1100010007901",7,231,0,0,0,3,241
"G1100010007901405","G1100010007901",1,141,0,0,0,1,143
"G1100010007901406","G1100010007901",2,112,0,1,1,0,116
"G1100010007901407","G1100010007901",3,458,0,0,0,0,461
"G1100010007903101","G1100010007903",1,163,0,0,0,1,165
"G1100010007903105","G1100010007903",7,73,0,0,0,0,80
"G1100010007903107","G1100010007903",1,230,0,0,0,0,231
"G1100010007903108","G1100010007903",0,200,0,0,0,0,200
"G1100010007903109","G1100010007903",0,156,1,0,0,8,165
"G1100010007903201","G1100010007903",0,34,0,0,0,0,34
"G1100010007903202","G1100010007903",0,95,1,0,0,1,97
"G1100010007903203","G1100010007903",2,79,0,0,0,5,86
"G1100010007903205","G1100010007903",3,140,0,0,0,1,144
"G1100010007903206","G1100010007903",0,127,2,0,0,6,135
"G1100010007903207","G1100010007903",2,186,0,0,0,0,188
"G1100010007903301","G1100010007903",0,168,1,0,0,0,169
"G1100010007903302","G1100010007903",1,53,0,2,2,0,58
"G1100010007903303","G1100010007903",0,87,1,0,0,0,88
"G1100010007903304","G1100010007903",0,113,0,0,0,0,113
"G1100010007903305","G1100010007903",1,3,0,0,0,0,4
"G1100010007903306","G1100010007903",1,24,0,0,0,0,25
"G1100010007903307","G1100010007903",0,35,0,0,0,0,35
"G1100010008001101","G1100010008001",2,117,0,3,3,0,125
"G1100010008001102","G1100010008001",14,31,0,1,1,0,47
"G1100010008001103","G1100010008001",7,169,0,0,0,2,178
"G1100010008001104","G1100010008001",21,115,0,1,1,0,138
"G1100010008001105","G1100010008001",16,138,0,0,0,0,154
"G1100010008001106","G1100010008001",30,115,0,0,0,0,145
"G1100010008001201","G1100010008001",48,161,0,1,1,6,217
"G1100010008001202","G1100010008001",52,153,0,0,0,0,205
"G1100010008001203","G1100010008001",33,185,0,0,0,0,218
"G1100010008001204","G1100010008001",22,90,1,4,4,3,124
"G1100010008001205","G1100010008001",6,70,0,0,0,0,76
"G1100010008001206","G1100010008001",10,89,0,2,2,0,103
"G1100010008001207","G1100010008001",11,53,0,2,2,2,70
"G1100010008001208","G1100010008001",8,82,0,0,0,0,90
"G1100010008001209","G1100010008001",2,63,0,1,1,0,67
"G1100010008001210","G1100010008001",7,45,0,0,0,1,53
"G1100010008001211","G1100010008001",32,90,2,1,1,0,126
"G1100010008001212","G1100010008001",24,91,0,0,0,1,116
"G1100010008001301","G1100010008001",48,129,0,4,4,2,187
"G1100010008001302","G1100010008001",12,126,0,0,0,0,138
"G1100010008001303","G1100010008001",25,42,0,1,1,1,70
"G1100010008001304","G1100010008001",30,96,0,0,0,0,126
"G1100010008001305","G1100010008001",22,77,0,0,0,0,99
"G1100010008001306","G1100010008001",2,90,0,0,0,0,92
"G1100010008002101","G1100010008002",0,38,0,0,0,0,38
"G1100010008002102","G1100010008002",0,95,0,0,0,4,99
"G1100010008002103","G1100010008002",0,90,0,1,1,4,96
"G1100010008002201","G1100010008002",9,150,0,0,0,1,160
"G1100010008002202","G1100010008002",1,255,1,0,0,1,258
"G1100010008002203","G1100010008002",19,127,1,0,0,3,150
"G1100010008002204","G1100010008002",10,122,0,0,0,0,132
"G1100010008002205","G1100010008002",76,264,2,1,1,5,349
"G1100010008002206","G1100010008002",24,93,0,0,0,0,117
"G1100010008002207","G1100010008002",22,97,1,0,0,0,120
"G1100010008002302","G1100010008002",5,107,0,0,0,0,112
"G1100010008002303","G1100010008002",3,219,0,3,3,0,228
"G1100010008002304","G1100010008002",14,17,0,1,1,0,33
"G1100010008002305","G1100010008002",11,92,0,0,0,1,104
"G1100010008002306","G1100010008002",7,81,1,0,0,0,89
"G1100010008002401","G1100010008002",54,92,1,2,2,1,152
"G1100010008002402","G1100010008002",2,20,0,0,0,0,22
"G1100010008002403","G1100010008002",153,60,0,2,2,11,228
"G1100010008002404","G1100010008002",9,71,0,0,0,0,80
"G1100010008002405","G1100010008002",38,160,0,0,0,0,198
"G1100010008002406","G1100010008002",29,89,0,0,0,2,120
"G1100010008002407","G1100010008002",20,73,0,0,0,2,95
"G1100010008002408","G1100010008002",99,32,1,2,2,0,136
"G1100010008002409","G1100010008002",82,77,0,0,0,1,160
"G1100010008002410","G1100010008002",11,24,0,0,0,0,35
"G1100010008002411","G1100010008002",95,117,0,1,1,1,215
"G1100010008002412","G1100010008002",52,9,0,0,0,3,64
"G1100010008110101","G1100010008110",34,65,0,1,1,3,104
"G1100010008110102","G1100010008110",25,43,0,0,0,0,68
"G1100010008110103","G1100010008110",83,134,0,4,4,17,242
"G1100010008110104","G1100010008110",3,33,0,0,0,0,36
"G1100010008110105","G1100010008110",41,83,0,0,0,2,126
"G1100010008110107","G1100010008110",11,80,0,0,0,5,96
"G1100010008110201","G1100010008110",40,50,0,5,5,0,100
"G1100010008110202","G1100010008110",34,96,0,1,1,1,133
"G1100010008110203","G1100010008110",88,71,0,2,2,5,168
"G1100010008110204","G1100010008110",52,103,0,2,2,1,160
"G1100010008110205","G1100010008110",26,54,1,0,0,2,83
"G1100010008110206","G1100010008110",60,28,0,2,2,0,92
"G1100010008110207","G1100010008110",82,99,0,1,1,3,186
"G1100010008110208","G1100010008110",78,93,0,4,4,1,180
"G1100010008110209","G1100010008110",111,37,0,6,6,7,167
"G1100010008110301","G1100010008110",24,3,0,0,0,0,27
"G1100010008110302","G1100010008110",29,7,0,5,5,3,49
"G1100010008110303","G1100010008110",80,10,0,0,0,7,97
"G1100010008110305","G1100010008110",108,39,3,2,2,1,155
"G1100010008110306","G1100010008110",165,34,0,0,0,8,207
"G1100010008110308","G1100010008110",82,1,0,3,3,0,89
"G1100010008110309","G1100010008110",67,7,0,0,0,2,76
"G1100010008110310","G1100010008110",101,20,0,5,5,4,135
"G11000100082101","G11000100082",94,39,0,1,1,1,136
"G11000100082102","G11000100082",120,9,0,3,3,0,135
"G11000100082105","G11000100082",152,19,0,3,3,5,182
"G11000100082107","G11000100082",122,4,0,2,2,0,130
"G11000100082108","G11000100082",282,7,0,3,3,6,301
"G11000100082201","G11000100082",98,10,1,8,8,5,130
"G11000100082202","G11000100082",81,25,0,10,10,5,131
"G11000100082203","G11000100082",88,5,0,0,0,0,93
"G11000100082204","G11000100082",103,14,0,0,0,1,118
"G11000100082205","G11000100082",45,1,0,1,1,2,50
"G11000100082206","G11000100082",99,5,0,2,2,4,112
"G11000100082207","G11000100082",131,2,4,5,5,3,150
"G11000100082208","G11000100082",16,0,0,0,0,0,16
"G11000100082209","G11000100082",47,1,0,2,2,1,53
"G11000100082210","G11000100082",156,12,0,2,2,5,177
"G11000100082211","G11000100082",44,0,0,0,0,3,47
"G11000100082213","G11000100082",151,7,0,4,4,7,173
"G11000100082214","G11000100082",5,0,0,0,0,1,6
"G11000100082215","G11000100082",223,18,0,3,3,12,259
"G11000100082216","G11000100082",1,0,0,0,0,0,1
"G11000100082217","G11000100082",7,1,0,0,0,0,8
"G11000100082218","G11000100082",95,12,2,2,2,4,117
"G11000100082219","G11000100082",29,0,0,1,1,0,31
"G11000100082220","G11000100082",70,2,1,1,1,1,76
"G11000100082221","G11000100082",104,2,0,2,2,3,113
"G1100010008301101","G1100010008301",29,95,0,0,0,0,124
"G1100010008301102","G1100010008301",43,48,0,9,9,0,109
"G1100010008301103","G1100010008301",46,51,0,9,9,3,118
"G1100010008301201","G1100010008301",93,64,0,5,5,9,176
"G1100010008301202","G1100010008301",1,0,0,0,0,0,1
"G1100010008301203","G1100010008301",111,51,0,1,1,4,168
"G1100010008301204","G1100010008301",121,89,0,1,1,9,221
"G1100010008301205","G1100010008301",114,25,2,0,0,3,144
"G1100010008301206","G1100010008301",92,41,1,1,1,1,137
"G1100010008301207","G1100010008301",36,1,0,1,1,1,40
"G1100010008301209","G1100010008301",36,2,0,0,0,1,39
"G1100010008301210","G1100010008301",179,93,0,2,2,3,279
"G1100010008301211","G1100010008301",73,95,0,2,2,3,175
"G1100010008301212","G1100010008301",44,98,1,0,0,5,148
"G1100010008301213","G1100010008301",71,92,0,3,3,1,170
"G1100010008301214","G1100010008301",110,47,0,1,1,4,163
"G1100010008301215","G1100010008301",64,36,0,0,0,3,103
"G1100010008301216","G1100010008301",10,3,0,0,0,0,13
"G1100010008301307","G1100010008301",27,24,0,0,0,1,52
"G1100010008302101","G1100010008302",27,81,0,4,4,4,120
"G1100010008302102","G1100010008302",35,115,1,0,0,4,155
"G1100010008302201","G1100010008302",53,82,0,5,5,4,149
"G1100010008302202","G1100010008302",43,26,0,0,0,0,69
"G1100010008302203","G1100010008302",2,16,0,0,0,0,18
"G1100010008302204","G1100010008302",94,56,0,0,0,2,152
"G1100010008302205","G1100010008302",35,0,0,0,0,0,35
"G1100010008302207","G1100010008302",103,27,0,0,0,2,132
"G1100010008302208","G1100010008302",75,23,1,0,0,7,106
"G1100010008302209","G1100010008302",2,0,0,0,0,0,2
"G1100010008302210","G1100010008302",109,16,0,1,1,3,130
"G1100010008302211","G1100010008302",0,3,0,0,0,0,3
"G1100010008302212","G1100010008302",79,61,1,0,0,3,144
"G1100010008302213","G1100010008302",106,106,0,4,4,7,227
"G1100010008302214","G1100010008302",93,93,2,1,1,7,197
"G1100010008302215","G1100010008302",61,67,0,1,1,4,134
"G1100010008302216","G1100010008302",107,97,1,1,1,1,208
"G1100010008402301","G1100010008402",0,0,0,0,0,0,0
"G1100010008402302","G1100010008402",12,503,0,0,0,2,517
"G1100010008402309","G1100010008402",24,75,0,2,2,4,107
"G1100010008402310","G1100010008402",17,44,0,7,7,1,76
"G1100010008402311","G1100010008402",29,110,0,0,0,1,140
"G1100010008402313","G1100010008402",60,129,4,1,1,7,202
"G1100010008402401","G1100010008402",6,230,0,0,0,10,246
"G1100010008402403","G1100010008402",18,37,0,0,0,2,57
"G1100010008402404","G1100010008402",61,47,0,6,6,0,120
"G1100010008402405","G1100010008402",97,124,1,1,1,27,251
"G1100010008402406","G1100010008402",50,64,0,1,1,3,119
"G1100010008402407","G1100010008402",35,81,0,0,0,4,120
"G1100010008402409","G1100010008402",49,221,4,1,1,1,277
"G1100010008402410","G1100010008402",36,251,1,2,2,0,292
"G1100010008402411","G1100010008402",20,75,1,2,2,2,102
"G1100010008402412","G1100010008402",21,118,0,0,0,2,141
"G1100010008402413","G1100010008402",18,0,0,0,0,0,18
"G1100010008410108","G1100010008410",0,74,1,0,0,0,75
"G1100010008410109","G1100010008410",7,129,0,2,2,5,145
"G1100010008410110","G1100010008410",2,57,0,0,0,0,59
"G1100010008410201","G1100010008410",8,93,0,0,0,0,101
"G1100010008410202","G1100010008410",3,38,0,0,0,0,41
"G1100010008410203","G1100010008410",0,38,0,0,0,0,38
"G1100010008410204","G1100010008410",3,114,0,0,0,2,119
"G1100010008410205","G1100010008410",4,138,0,0,0,0,142
"G1100010008410206","G1100010008410",4,65,0,0,0,0,69
"G1100010008410207","G1100010008410",8,145,0,0,0,0,153
"G1100010008410208","G1100010008410",5,130,0,2,2,0,139
"G1100010008410209","G1100010008410",0,56,0,0,0,0,56
"G1100010008410210","G1100010008410",7,72,0,1,1,0,81
"G1100010008410301","G1100010008410",6,125,0,0,0,1,132
"G1100010008410302","G1100010008410",0,0,0,0,0,0,0
"G1100010008410303","G1100010008410",0,26,0,0,0,0,26
"G1100010008410304","G1100010008410",2,95,0,0,0,5,102
"G1100010008410305","G1100010008410",2,74,0,0,0,2,78
"G1100010008410306","G1100010008410",4,145,0,0,0,11,160
"G1100010008510101","G1100010008510",8,132,0,0,0,8,148
"G1100010008510102","G1100010008510",6,130,0,0,0,14,150
"G1100010008510103","G1100010008510",2,180,0,0,0,9,191
"G1100010008510104","G1100010008510",7,205,2,1,1,5,221
"G1100010008510105","G1100010008510",4,161,0,3,3,1,172
"G1100010008510106","G1100010008510",5,22,0,2,2,0,31
"G1100010008510107","G1100010008510",1,59,0,0,0,2,62
"G1100010008510201","G1100010008510",7,115,0,0,0,2,124
"G1100010008510202","G1100010008510",4,128,1,0,0,0,133
"G1100010008510203","G1100010008510",10,123,0,1,1,1,136
"G1100010008510204","G1100010008510",10,206,0,0,0,11,227
"G1100010008510205","G1100010008510",1,56,0,0,0,0,57
"G1100010008510208","G1100010008510",0,281,2,2,2,2,289
"G1100010008510301","G1100010008510",4,56,0,0,0,2,62
"G1100010008510302","G1100010008510",15,111,0,0,0,2,128
"G1100010008510303","G1100010008510",2,102,0,0,0,0,104
"G1100010008510304","G1100010008510",9,114,0,0,0,0,123
"G1100010008510305","G1100010008510",0,121,0,0,0,0,121
"G1100010008510306","G1100010008510",7,69,0,1,1,1,79
"G1100010008510401","G1100010008510",5,82,0,1,1,0,89
"G1100010008510402","G1100010008510",0,22,0,0,0,0,22
"G1100010008510403","G1100010008510",7,62,0,0,0,1,70
"G1100010008510405","G1100010008510",2,24,0,0,0,0,26
"G1100010008510406","G1100010008510",13,62,0,1,1,0,77
"G1100010008510407","G1100010008510",1,10,0,0,0,0,11
"G1100010008510408","G1100010008510",2,61,0,1,1,0,65
"G1100010008510501","G1100010008510",0,6,0,0,0,0,6
"G1100010008510502","G1100010008510",4,145,2,0,0,12,163
"G1100010008510503","G1100010008510",5,126,0,0,0,0,131
"G1100010008510504","G1100010008510",3,170,1,1,1,0,176
"G1100010008510506","G1100010008510",2,126,0,2,2,0,132
"G1100010008510601","G1100010008510",1,88,0,6,6,0,101
"G1100010008510602","G1100010008510",1,59,0,0,0,0,60
"G11000100086101","G11000100086",0,63,0,0,0,5,68
"G11000100086102","G11000100086",0,4,0,0,0,0,4
"G11000100086108","G11000100086",5,66,0,0,0,4,75
"G11000100086202","G11000100086",2,3,0,0,0,0,5
"G11000100086305","G11000100086",0,5,0,0,0,0,5
"G1100010008701101","G1100010008701",0,151,0,0,0,0,151
"G1100010008701107","G1100010008701",0,64,0,0,0,0,64
"G1100010008701401","G1100010008701",4,77,1,0,0,3,85
"G1100010008701402","G1100010008701",0,53,0,0,0,0,53
"G1100010008701403","G1100010008701",2,206,1,0,0,0,209
"G1100010008701405","G1100010008701",9,203,0,12,12,1,237
"G1100010008701407","G1100010008701",6,176,1,3,3,0,189
"G1100010008701408","G1100010008701",3,397,1,0,0,2,403
"G1100010008701409","G1100010008701",0,21,0,0,0,0,21
"G1100010008701410","G1100010008701",1,57,0,0,0,14,72
"G1100010008701411","G1100010008701",0,110,0,0,0,0,110
"G1100010008701412","G1100010008701",4,101,0,0,0,5,110
"G1100010008701501","G1100010008701",11,128,0,0,0,0,139
"G1100010008701502","G1100010008701",0,131,0,1,1,0,133
"G1100010008701503","G1100010008701",0,191,0,0,0,0,191
"G1100010008701504","G1100010008701",1,115,0,0,0,0,116
"G1100010008701505","G1100010008701",1,45,0,0,0,0,46
"G1100010008701506","G1100010008701",0,91,0,0,0,0,91
"G1100010008701507","G1100010008701",0,125,0,0,0,5,130
"G1100010008701509","G1100010008701",0,146,0,0,0,0,146
"G1100010008701510","G1100010008701",1,121,0,0,0,0,122
"G1100010008702102","G1100010008702",0,4,0,0,0,0,4
"G1100010008702103","G1100010008702",0,91,0,0,0,0,91
"G1100010008702104","G1100010008702",0,68,0,1,1,2,72
"G1100010008702105","G1100010008702",1,196,1,0,0,11,209
"G1100010008702106","G1100010008702",6,79,0,0,0,0,85
"G1100010008702201","G1100010008702",0,155,0,0,0,1,156
"G1100010008702202","G1100010008702",1,182,0,0,0,6,189
"G1100010008702203","G1100010008702",1,139,0,0,0,1,141
"G1100010008702204","G1100010008702",1,70,0,0,0,0,71
"G1100010008702205","G1100010008702",2,50,0,0,0,0,52
"G1100010008702206","G1100010008702",0,240,0,0,0,1,241
"G1100010008702301","G1100010008702",0,50,0,0,0,0,50
"G1100010008702302","G1100010008702",12,184,1,1,1,5,204
"G1100010008702303","G1100010008702",1,166,0,0,0,8,175
"G1100010008702304","G1100010008702",0,70,0,0,0,0,70
"G1100010008702305","G1100010008702",2,91,0,0,0,0,93
"G1100010008702306","G1100010008702",0,88,0,0,0,0,88
"G1100010008702307","G1100010008702",4,84,0,0,0,7,95
"G1100010008702310","G1100010008702",0,11,0,0,0,0,11
"G1100010008802101","G1100010008802",0,108,0,0,0,0,108
"G1100010008802102","G1100010008802",5,139,0,0,0,1,145
"G1100010008802103","G1100010008802",5,218,1,1,1,0,226
"G1100010008802104","G1100010008802",0,81,0,0,0,4,85
"G1100010008802105","G1100010008802",0,101,0,0,0,2,103
"G1100010008802106","G1100010008802",0,83,0,1,1,1,86
"G1100010008802201","G1100010008802",0,108,0,0,0,0,108
"G1100010008802202","G1100010008802",0,108,0,0,0,3,111
"G1100010008802203","G1100010008802",0,105,0,0,0,0,105
"G1100010008802204","G1100010008802",0,122,0,0,0,0,122
"G1100010008802205","G1100010008802",1,118,0,0,0,0,119
"G1100010008802206","G1100010008802",0,200,1,0,0,4,205
"G1100010008802207","G1100010008802",0,116,0,0,0,0,116
"G1100010008802208","G1100010008802",0,48,0,0,0,0,48
"G1100010008802209","G1100010008802",0,51,0,0,0,0,51
"G1100010008802210","G1100010008802",0,91,0,0,0,0,91
"G1100010008802211","G1100010008802",0,91,0,0,0,1,92
"G1100010008802212","G1100010008802",0,53,0,0,0,0,53
"G1100010008802301","G1100010008802",2,295,0,3,3,0,303
"G1100010008802302","G1100010008802",7,231,0,1,1,1,241
"G1100010008802303","G1100010008802",3,223,0,1,1,0,228
"G1100010008802304","G1100010008802",2,127,0,0,0,0,129
"G1100010008802305","G1100010008802",2,309,0,0,0,0,311
"G1100010008802306","G1100010008802",3,219,0,0,0,12,234
"G1100010008802401","G1100010008802",0,198,1,0,0,3,202
"G1100010008802402","G1100010008802",0,244,2,0,0,0,246
"G1100010008802403","G1100010008802",1,290,0,1,1,9,302
"G1100010008802404","G1100010008802",5,198,0,0,0,0,203
"G1100010008802405","G1100010008802",0,223,0,0,0,0,223
"G1100010008802406","G1100010008802",1,182,0,0,0,1,184
"G1100010008803103","G1100010008803",1,186,0,0,0,0,187
"G1100010008803501","G1100010008803",0,119,0,0,0,0,119
"G1100010008803502","G1100010008803",0,102,0,0,0,0,102
"G1100010008803503","G1100010008803",0,151,0,0,0,0,151
"G1100010008803504","G1100010008803",0,147,0,0,0,0,147
"G1100010008803505","G1100010008803",2,67,0,0,0,0,69
"G1100010008803506","G1100010008803",0,39,0,0,0,2,41
"G1100010008803508","G1100010008803",0,39,0,0,0,0,39
"G1100010008803509","G1100010008803",2,286,0,0,0,1,289
"G1100010008803510","G1100010008803",0,54,0,0,0,0,54
"G1100010008803602","G1100010008803",448,138,0,36,36,43,701
"G1100010008803603","G1100010008803",0,57,0,0,0,0,57
"G1100010008803620","G1100010008803",0,155,0,0,0,1,156
"G1100010008803621","G1100010008803",0,96,0,0,0,0,96
"G1100010008803702","G1100010008803",0,0,0,4,4,0,8
"G1100010008804201","G1100010008804",0,128,0,1,1,0,130
"G1100010008804202","G1100010008804",1,192,0,0,0,0,193
"G1100010008804203","G1100010008804",0,97,0,0,0,1,98
"G1100010008804205","G1100010008804",0,103,0,0,0,0,103
"G1100010008804206","G1100010008804",0,79,0,0,0,0,79
"G1100010008804207","G1100010008804",0,62,0,0,0,0,62
"G1100010008804301","G1100010008804",0,179,0,0,0,0,179
"G1100010008804302","G1100010008804",0,55,0,0,0,0,55
"G1100010008804303","G1100010008804",0,449,2,0,0,0,451
"G1100010008804304","G1100010008804",2,176,0,4,4,1,187
"G1100010008804305","G1100010008804",5,164,0,0,0,0,169
"G1100010008804306","G1100010008804",1,107,0,0,0,0,108
"G1100010008804307","G1100010008804",1,170,0,0,0,10,181
"G1100010008804401","G1100010008804",2,327,3,0,0,2,334
"G1100010008804402","G1100010008804",0,33,0,0,0,0,33
"G1100010008804403","G1100010008804",0,316,0,0,0,0,316
"G1100010008804404","G1100010008804",0,96,0,0,0,0,96
"G1100010008804406","G1100010008804",0,159,0,3,3,0,165
"G1100010008804407","G1100010008804",3,160,0,0,0,0,163
"G1100010008903101","G1100010008903",0,199,0,0,0,0,199
"G1100010008903103","G1100010008903",0,12,0,0,0,0,12
"G1100010008903104","G1100010008903",0,236,4,0,0,0,240
"G1100010008903105","G1100010008903",0,146,0,4,4,0,154
"G1100010008903106","G1100010008903",2,103,2,1,1,0,109
"G1100010008903107","G1100010008903",1,104,0,0,0,0,105
"G1100010008903108","G1100010008903",1,69,0,0,0,0,70
"G1100010008903109","G1100010008903",1,76,0,0,0,1,78
"G1100010008903110","G1100010008903",1,234,0,5,5,2,247
"G1100010008903111","G1100010008903",2,80,0,0,0,0,82
"G1100010008903112","G1100010008903",1,98,0,0,0,0,99
"G1100010008903113","G1100010008903",0,229,0,0,0,0,229
"G1100010008903114","G1100010008903",0,121,0,0,0,0,121
"G1100010008903115","G1100010008903",0,146,0,0,0,0,146
"G1100010008903116","G1100010008903",1,160,0,0,0,0,161
"G1100010008903119","G1100010008903",0,1,0,0,0,0,1
"G1100010008903122","G1100010008903",2,784,0,2,2,10,800
"G1100010008903123","G1100010008903",2,446,0,1,1,5,455
"G1100010008903124","G1100010008903",0,62,0,0,0,0,62
"G1100010008904102","G1100010008904",2,487,0,0,0,2,491
"G1100010008904103","G1100010008904",4,211,0,0,0,0,215
"G1100010008904105","G1100010008904",0,231,1,0,0,1,233
"G1100010008904106","G1100010008904",0,110,0,0,0,4,114
"G1100010008904107","G1100010008904",3,263,0,0,0,0,266
"G1100010008904108","G1100010008904",2,352,1,0,0,9,364
"G1100010008904109","G1100010008904",0,126,1,0,0,0,127
"G1100010008904110","G1100010008904",3,1118,1,0,0,0,1122
"G1100010008904111","G1100010008904",0,12,0,0,0,0,12
"G1100010008904201","G1100010008904",3,204,0,0,0,0,207
"G1100010008904202","G1100010008904",1,131,0,0,0,3,135
"G1100010008904203","G1100010008904",0,92,0,0,0,5,97
"G1100010008904204","G1100010008904",0,121,0,0,0,3,124
"G1100010008904205","G1100010008904",0,168,0,0,0,0,168
"G1100010008904206","G1100010008904",2,168,2,0,0,10,182
"G1100010009001101","G1100010009001",18,727,4,0,0,20,769
"G1100010009001102","G1100010009001",0,7,0,0,0,0,7
"G1100010009001103","G1100010009001",3,344,0,0,0,1,348
"G1100010009001121","G1100010009001",0,12,0,0,0,0,12
"G1100010009001122","G1100010009001",9,1018,0,3,3,13,1046
"G1100010009002101","G1100010009002",2,12,0,0,0,0,14
"G1100010009002102","G1100010009002",0,37,0,0,0,0,37
"G1100010009002103","G1100010009002",4,14,0,0,0,0,18
"G1100010009002104","G1100010009002",3,11,0,0,0,0,14
"G1100010009002105","G1100010009002",0,36,0,0,0,0,36
"G1100010009002106","G1100010009002",1,35,0,0,0,0,36
"G1100010009002202","G1100010009002",1,94,0,0,0,2,97
"G1100010009002203","G1100010009002",1,0,0,0,0,0,1
"G1100010009002204","G1100010009002",5,42,0,0,0,0,47
"G1100010009002205","G1100010009002",1,82,0,0,0,1,84
"G1100010009002206","G1100010009002",0,99,0,0,0,0,99
"G1100010009002207","G1100010009002",1,42,0,0,0,2,45
"G1100010009002208","G1100010009002",0,21,0,0,0,0,21
"G1100010009002209","G1100010009002",0,20,0,0,0,3,23
"G1100010009002210","G1100010009002",0,28,0,0,0,0,28
"G1100010009002211","G1100010009002",1,36,0,0,0,0,37
"G1100010009002212","G1100010009002",0,18,0,0,0,0,18
"G1100010009002214","G1100010009002",1,123,0,0,0,0,124
"G1100010009002215","G1100010009002",0,10,0,0,0,0,10
"G1100010009002235","G1100010009002",0,17,0,0,0,0,17
"G1100010009002236","G1100010009002",0,13,0,0,0,0,13
"G1100010009002237","G1100010009002",3,56,0,0,0,0,59
"G1100010009002301","G1100010009002",0,4,0,0,0,0,4
"G1100010009002303","G1100010009002",0,12,0,0,0,0,12
"G1100010009002305","G1100010009002",1,240,0,0,0,9,250
"G1100010009002321","G1100010009002",4,45,0,0,0,0,49
"G1100010009002322","G1100010009002",7,61,1,0,0,0,69
"G1100010009002323","G1100010009002",0,38,0,9,9,0,56
"G1100010009002324","G1100010009002",0,8,0,0,0,0,8
"G1100010009002326","G1100010009002",8,124,0,0,0,2,134
"G1100010009102101","G1100010009102",0,20,0,0,0,0,20
"G1100010009102103","G1100010009102",5,51,0,0,0,0,56
"G1100010009102104","G1100010009102",0,20,0,0,0,0,20
"G1100010009102105","G1100010009102",0,19,0,0,0,0,19
"G1100010009102106","G1100010009102",8,223,1,0,0,0,232
"G1100010009102107","G1100010009102",0,63,0,0,0,0,63
"G1100010009102108","G1100010009102",4,45,0,1,1,0,51
"G1100010009102109","G1100010009102",3,90,1,0,0,0,94
"G1100010009102111","G1100010009102",3,24,1,0,0,2,30
"G1100010009102112","G1100010009102",0,65,0,0,0,1,66
"G1100010009102113","G1100010009102",0,39,0,0,0,0,39
"G1100010009102114","G1100010009102",0,17,1,1,1,0,20
"G1100010009102115","G1100010009102",0,148,0,0,0,0,148
"G1100010009102202","G1100010009102",4,596,0,0,0,6,606
"G1100010009102203","G1100010009102",0,120,0,0,0,0,120
"G1100010009102204","G1100010009102",1,250,1,1,1,3,257
"G1100010009102205","G1100010009102",0,357,4,0,0,0,361
"G1100010009102206","G1100010009102",0,200,0,0,0,0,200
"G1100010009102207","G1100010009102",1,613,0,0,0,0,614
"G1100010009102208","G1100010009102",2,622,1,0,0,2,627
"G1100010009102209","G1100010009102",3,181,0,0,0,0,184
"G1100010009102210","G1100010009102",1,247,0,0,0,1,249
"G1100010009102211","G1100010009102",0,270,0,2,2,0,274
"G1100010009102212","G1100010009102",5,70,0,0,0,4,79
"G1100010009102213","G1100010009102",0,98,0,0,0,0,98
"G1100010009102214","G1100010009102",0,202,0,0,0,0,202
"G1100010009102215","G1100010009102",0,36,0,0,0,1,37
"G1100010009102217","G1100010009102",2,81,0,0,0,0,83
"G1100010009110201","G1100010009110",4,126,0,0,0,5,135
"G1100010009110202","G1100010009110",2,93,0,5,5,3,108
"G1100010009110203","G1100010009110",1,133,0,0,0,3,137
"G1100010009110204","G1100010009110",6,128,0,0,0,0,134
"G1100010009110205","G1100010009110",6,40,0,1,1,1,49
"G1100010009110206","G1100010009110",1,72,0,0,0,0,73
"G1100010009110207","G1100010009110",2,103,0,0,0,0,105
"G1100010009110401","G1100010009110",0,73,0,2,2,0,77
"G1100010009110402","G1100010009110",4,54,0,0,0,0,58
"G1100010009110403","G1100010009110",0,54,0,0,0,0,54
"G1100010009110404","G1100010009110",11,417,0,0,0,5,433
"G1100010009110405","G1100010009110",0,51,0,0,0,0,51
"G1100010009110406","G1100010009110",2,85,0,0,0,4,91
"G1100010009110407","G1100010009110",0,85,1,0,0,0,86
"G1100010009110408","G1100010009110",2,21,0,0,0,2,25
"G1100010009110409","G1100010009110",1,66,3,0,0,0,70
"G1100010009110410","G1100010009110",0,5,0,0,0,0,5
"G1100010009110411","G1100010009110",4,8,0,0,0,0,12
"G1100010009110501","G1100010009110",2,22,0,0,0,0,24
"G1100010009110502","G1100010009110",4,48,0,0,0,1,53
"G1100010009110503","G1100010009110",6,31,0,0,0,0,37
"G1100010009110504","G1100010009110",20,59,0,0,0,0,79
"G1100010009110505","G1100010009110",1,36,0,0,0,0,37
"G1100010009110506","G1100010009110",0,32,0,0,0,0,32
"G1100010009110507","G1100010009110",3,65,2,0,0,0,70
"G1100010009110508","G1100010009110",12,70,0,0,0,0,82
"G1100010009110512","G1100010009110",0,27,0,0,0,0,27
"G1100010009110513","G1100010009110",0,17,0,0,0,0,17
"G1100010009110604","G1100010009110",0,25,0,0,0,0,25
"G1100010009110605","G1100010009110",0,75,0,0,0,0,75
"G1100010009110613","G1100010009110",9,41,0,0,0,0,50
"G1100010009110614","G1100010009110",4,68,0,0,0,0,72
"G1100010009110615","G1100010009110",14,40,5,0,0,0,59
"G1100010009110616","G1100010009110",4,129,0,0,0,0,133
"G1100010009110617","G1100010009110",8,124,0,0,0,0,132
"G1100010009110618","G1100010009110",19,76,0,0,0,0,95
"G1100010009110621","G1100010009110",0,16,0,0,0,4,20
"G1100010009110622","G1100010009110",10,109,0,0,0,6,125
"G1100010009110623","G1100010009110",0,33,0,0,0,0,33
"G1100010009110624","G1100010009110",2,43,0,0,0,16,61
"G1100010009110625","G1100010009110",4,46,1,0,0,0,51
"G1100010009110626","G1100010009110",6,70,0,0,0,0,76
"G1100010009110627","G1100010009110",0,66,0,0,0,1,67
"G1100010009110628","G1100010009110",1,87,0,0,0,5,93
"G1100010009110629","G1100010009110",6,202,0,0,0,1,209
"G1100010009110630","G1100010009110",2,32,0,1,1,0,36
"G1100010009110631","G1100010009110",4,24,6,0,0,7,41
"G1100010009203401","G1100010009203",5,123,0,0,0,10,138
"G1100010009203402","G1100010009203",5,115,0,0,0,1,121
"G1100010009203403","G1100010009203",1,134,1,0,0,1,137
"G1100010009203404","G1100010009203",5,132,0,1,1,2,141
"G1100010009203405","G1100010009203",0,36,0,0,0,0,36
"G1100010009203406","G1100010009203",0,151,0,0,0,0,151
"G1100010009203501","G1100010009203",20,173,1,0,0,1,195
"G1100010009203502","G1100010009203",23,903,0,8,8,21,963
"G1100010009203601","G1100010009203",0,114,0,0,0,0,114
"G1100010009203602","G1100010009203",2,116,0,0,0,6,124
"G1100010009203603","G1100010009203",32,605,2,2,2,25,668
"G1100010009203604","G1100010009203",1,106,0,0,0,0,107
"G1100010009203605","G1100010009203",2,121,0,0,0,2,125
"G1100010009203606","G1100010009203",0,17,0,0,0,0,17
"G1100010009203607","G1100010009203",4,176,0,0,0,3,183
"G1100010009210301","G1100010009210",12,33,0,0,0,0,45
"G1100010009210304","G1100010009210",0,0,0,0,0,0,0
"G1100010009210306","G1100010009210",21,22,0,3,3,3,52
"G1100010009210307","G1100010009210",19,62,0,3,3,8,95
"G1100010009210308","G1100010009210",22,59,0,2,2,2,87
"G1100010009210309","G1100010009210",231,464,0,3,3,21,722
"G1100010009210310","G1100010009210",31,44,1,2,2,7,87
"G1100010009210311","G1100010009210",9,108,0,0,0,0,117
"G1100010009210312","G1100010009210",0,189,0,1,1,6,197
"G1100010009210401","G1100010009210",324,10,0,6,6,19,365
"G1100010009240201","G1100010009240",12,1412,3,1,1,31,1460
"G1100010009240202","G1100010009240",6,164,0,2,2,0,174
"G1100010009240203","G1100010009240",0,65,0,0,0,0,65
"G1100010009240204","G1100010009240",8,159,0,0,0,6,173
"G1100010009240205","G1100010009240",4,217,0,0,0,2,223
"G1100010009240401","G1100010009240",2,184,1,0,0,5,192
"G1100010009240402","G1100010009240",3,139,0,0,0,0,142
"G1100010009301101","G1100010009301",9,87,0,0,0,1,97
"G1100010009301102","G1100010009301",10,67,0,0,0,1,78
"G1100010009301103","G1100010009301",19,34,0,1,1,8,63
"G1100010009301104","G1100010009301",10,47,0,1,1,0,59
"G1100010009301105","G1100010009301",4,41,0,0,0,0,45
"G1100010009301106","G1100010009301",5,58,0,1,1,0,65
"G1100010009301107","G1100010009301",2,44,0,0,0,13,59
"G1100010009301108","G1100010009301",12,34,0,0,0,0,46
"G1100010009301109","G1100010009301",9,20,0,1,1,3,34
"G1100010009301110","G1100010009301",7,69,0,0,0,6,82
"G1100010009301111","G1100010009301",3,53,0,0,0,0,56
"G1100010009301112","G1100010009301",0,47,0,0,0,4,51
"G1100010009301113","G1100010009301",2,49,0,0,0,3,54
"G1100010009301114","G1100010009301",8,45,0,1,1,0,55
"G1100010009301115","G1100010009301",3,41,0,0,0,0,44
"G1100010009301201","G1100010009301",9,46,0,3,3,0,61
"G1100010009301202","G1100010009301",8,45,0,0,0,0,53
"G1100010009301203","G1100010009301",0,11,0,0,0,0,11
"G1100010009301204","G1100010009301",0,9,0,1,1,0,11
"G1100010009301205","G1100010009301",8,31,0,0,0,0,39
"G1100010009301206","G1100010009301",2,33,0,0,0,0,35
"G1100010009301207","G1100010009301",3,40,0,0,0,7,50
"G1100010009301208","G1100010009301",0,15,0,0,0,0,15
"G1100010009301209","G1100010009301",2,28,0,0,0,0,30
"G1100010009301210","G1100010009301",0,10,0,0,0,0,10
"G1100010009301211","G1100010009301",1,6,0,0,0,0,7
"G1100010009301214","G1100010009301",2,58,0,0,0,0,60
"G1100010009301301","G1100010009301",0,4,0,0,0,0,4
"G1100010009301302","G1100010009301",1,30,3,0,0,0,34
"G1100010009301303","G1100010009301",0,8,0,0,0,0,8
"G1100010009301308","G1100010009301",7,36,1,0,0,0,44
"G1100010009301310","G1100010009301",5,40,0,0,0,15,60
"G1100010009301311","G1100010009301",10,50,0,0,0,0,60
"G1100010009301312","G1100010009301",8,53,0,0,0,2,63
"G1100010009301313","G1100010009301",5,41,0,0,0,3,49
"G1100010009301401","G1100010009301",10,72,0,0,0,1,83
"G1100010009301402","G1100010009301",15,21,0,1,1,1,39
"G1100010009301403","G1100010009301",12,72,0,3,3,1,91
"G1100010009301404","G1100010009301",43,62,0,0,0,0,105
"G1100010009301405","G1100010009301",9,64,0,0,0,3,76
"G1100010009301406","G1100010009301",27,66,0,5,5,0,103
"G1100010009301407","G1100010009301",23,24,0,3,3,1,54
"G1100010009301408","G1100010009301",34,36,0,4,4,4,82
"G1100010009301409","G1100010009301",20,15,0,0,0,5,40
"G1100010009301410","G1100010009301",22,51,0,0,0,8,81
"G1100010009301501","G1100010009301",48,44,0,7,7,1,107
"G1100010009301502","G1100010009301",23,22,0,3,3,1,52
"G1100010009301507","G1100010009301",30,18,0,0,0,7,55
"G1100010009301508","G1100010009301",62,35,0,1,1,3,102
"G1100010009301509","G1100010009301",47,13,0,2,2,3,67
"G1100010009301510","G1100010009301",3,2,0,1,1,0,7
"G1100010009301511","G1100010009301",4,33,0,0,0,0,37
"G1100010009301512","G1100010009301",3,20,0,0,0,0,23
"G1100010009301601","G1100010009301",4,35,0,0,0,6,45
"G1100010009301602","G1100010009301",3,16,0,3,3,0,25
"G1100010009301603","G1100010009301",33,32,0,0,0,0,65
"G1100010009301604","G1100010009301",13,64,0,9,9,10,105
"G1100010009301605","G1100010009301",12,65,0,2,2,1,82
"G1100010009301606","G1100010009301",9,65,0,0,0,0,74
"G1100010009301607","G1100010009301",2,77,1,0,0,0,80
"G1100010009301608","G1100010009301",3,28,0,3,3,0,37
"G1100010009301609","G1100010009301",11,100,0,7,7,0,125
"G1100010009301610","G1100010009301",7,55,0,4,4,4,74
"G1100010009301611","G1100010009301",1,82,0,0,0,0,83
"G1100010009301612","G1100010009301",7,43,1,2,2,2,57
"G1100010009302701","G1100010009302",5,281,0,0,0,1,287
"G1100010009302704","G1100010009302",9,95,0,0,0,1,105
"G1100010009302705","G1100010009302",0,115,0,0,0,11,126
"G1100010009302706","G1100010009302",14,83,0,0,0,5,102
"G1100010009302707","G1100010009302",1,58,3,0,0,0,62
"G1100010009302708","G1100010009302",0,70,0,0,0,0,70
"G1100010009302711","G1100010009302",3,68,0,0,0,0,71
"G1100010009302712","G1100010009302",4,81,0,0,0,2,87
"G1100010009302801","G1100010009302",1,78,0,0,0,0,79
"G1100010009302802","G1100010009302",2,47,0,0,0,0,49
"G1100010009302803","G1100010009302",13,118,0,1,1,2,135
"G1100010009302804","G1100010009302",2,80,2,1,1,3,89
"G1100010009302805","G1100010009302",1,57,0,0,0,5,63
"G1100010009302806","G1100010009302",2,36,0,2,2,0,42
"G1100010009302808","G1100010009302",3,266,0,0,0,4,273
"G1100010009410101","G1100010009410",1,21,0,0,0,0,22
"G1100010009410102","G1100010009410",0,1,0,0,0,0,1
"G1100010009410103","G1100010009410",0,13,0,0,0,0,13
"G1100010009410104","G1100010009410",2,52,0,0,0,1,55
"G1100010009410105","G1100010009410",0,6,0,0,0,0,6
"G1100010009410106","G1100010009410",4,30,0,0,0,0,34
"G1100010009410107","G1100010009410",3,55,0,0,0,0,58
"G1100010009410108","G1100010009410",1,35,0,0,0,0,36
"G1100010009410109","G1100010009410",2,35,0,1,1,0,39
"G1100010009410110","G1100010009410",7,22,0,0,0,0,29
"G1100010009410111","G1100010009410",4,38,0,0,0,0,42
"G1100010009410112","G1100010009410",3,47,0,0,0,1,51
"G1100010009410113","G1100010009410",0,22,0,0,0,0,22
"G1100010009410114","G1100010009410",6,32,0,0,0,0,38
"G1100010009410115","G1100010009410",0,29,0,0,0,0,29
"G1100010009410116","G1100010009410",0,18,0,0,0,0,18
"G1100010009410117","G1100010009410",0,29,0,0,0,3,32
"G1100010009410118","G1100010009410",11,68,0,0,0,0,79
"G1100010009410119","G1100010009410",0,25,0,0,0,0,25
"G1100010009410201","G1100010009410",2,96,0,0,0,0,98
"G1100010009410202","G1100010009410",0,20,0,0,0,0,20
"G1100010009410204","G1100010009410",0,29,0,0,0,0,29
"G1100010009410207","G1100010009410",0,21,0,0,0,0,21
"G1100010009410208","G1100010009410",47,124,0,2,2,12,187
"G1100010009410209","G1100010009410",0,32,4,0,0,0,36
"G1100010009410211","G1100010009410",7,88,0,0,0,0,95
"G1100010009410213","G1100010009410",5,65,0,0,0,0,70
"G1100010009410215","G1100010009410",1,64,0,0,0,2,67
"G1100010009410301","G1100010009410",3,57,0,1,1,4,66
"G1100010009410302","G1100010009410",0,94,0,0,0,0,94
"G1100010009410303","G1100010009410",6,80,0,0,0,1,87
"G1100010009410304","G1100010009410",4,74,0,0,0,0,78
"G1100010009410305","G1100010009410",5,78,0,0,0,0,83
"G1100010009410306","G1100010009410",0,31,0,2,2,0,35
"G1100010009410307","G1100010009410",1,50,0,4,4,0,59
"G1100010009410308","G1100010009410",0,24,0,0,0,0,24
"G1100010009410309","G1100010009410",2,52,0,0,0,0,54
"G1100010009410310","G1100010009410",3,56,0,0,0,0,59
"G1100010009410311","G1100010009410",5,76,0,0,0,0,81
"G1100010009410312","G1100010009410",0,65,0,0,0,0,65
"G1100010009410313","G1100010009410",0,68,0,0,0,4,72
"G1100010009410314","G1100010009410",7,54,0,0,0,0,61
"G1100010009410401","G1100010009410",1,7,0,0,0,0,8
"G1100010009410402","G1100010009410",0,25,0,0,0,0,25
"G1100010009410403","G1100010009410",5,42,0,0,0,0,47
"G1100010009410404","G1100010009410",2,34,0,0,0,0,36
"G1100010009410405","G1100010009410",2,28,0,0,0,2,32
"G1100010009410406","G1100010009410",5,83,0,0,0,0,88
"G1100010009410407","G1100010009410",2,32,1,1,1,0,37
"G1100010009410408","G1100010009410",2,71,0,0,0,0,73
"G1100010009410409","G1100010009410",0,43,0,0,0,0,43
"G1100010009410410","G1100010009410",1,49,0,0,0,1,51
"G1100010009410411","G1100010009410",0,35,1,0,0,0,36
"G1100010009410412","G1100010009410",2,48,0,0,0,0,50
"G1100010009410413","G1100010009410",3,60,0,0,0,3,66
"G1100010009410415","G1100010009410",3,47,0,2,2,0,54
"G1100010009410416","G1100010009410",10,75,0,0,0,0,85
"G1100010009410417","G1100010009410",4,94,0,0,0,0,98
"G1100010009410418","G1100010009410",1,28,2,0,0,1,32
"G1100010009410501","G1100010009410",1,76,0,0,0,3,80
"G1100010009410502","G1100010009410",2,42,0,0,0,0,44
"G1100010009410503","G1100010009410",0,78,0,0,0,0,78
"G1100010009410506","G1100010009410",1,24,0,0,0,0,25
"G1100010009410507","G1100010009410",1,14,0,0,0,0,15
"G1100010009410508","G1100010009410",0,263,0,0,0,3,266
"G1100010009410509","G1100010009410",0,0,0,0,0,0,0
"G1100010009410601","G1100010009410",17,116,0,0,0,1,134
"G1100010009410602","G1100010009410",2,66,0,0,0,0,68
"G1100010009410603","G1100010009410",5,14,0,0,0,0,19
"G1100010009410606","G1100010009410",4,32,0,0,0,0,36
"G1100010009410607","G1100010009410",0,62,0,0,0,0,62
"G1100010009410608","G1100010009410",2,89,0,1,1,0,93
"G1100010009410609","G1100010009410",6,103,0,0,0,0,109
"G1100010009410610","G1100010009410",12,101,0,1,1,6,121
"G1100010009410611","G1100010009410",6,259,0,0,0,6,271
"G1100010009410612","G1100010009410",0,23,2,0,0,0,25
"G1100010009410619","G1100010009410",0,9,0,0,0,0,9
"G1100010009410620","G1100010009410",1,99,0,0,0,0,100
"G1100010009410632","G1100010009410",3,49,0,0,0,0,52
"G1100010009501101","G1100010009501",2,110,1,0,0,7,120
"G1100010009501103","G1100010009501",67,274,0,7,7,6,361
"G1100010009501104","G1100010009501",1,47,0,0,0,0,48
"G1100010009501105","G1100010009501",5,721,9,3,3,14,755
"G1100010009501106","G1100010009501",2,173,0,0,0,0,175
"G1100010009501107","G1100010009501",3,162,0,2,2,0,169
"G1100010009501108","G1100010009501",5,336,2,7,7,5,362
"G1100010009501202","G1100010009501",1554,145,8,27,27,97,1858
"G1100010009501203","G1100010009501",0,0,0,0,0,7,7
"G1100010009501206","G1100010009501",195,25,0,2,2,12,236
"G1100010009501301","G1100010009501",1,25,0,0,0,0,26
"G1100010009501302","G1100010009501",4,62,0,0,0,1,67
"G1100010009501303","G1100010009501",11,84,1,6,6,0,108
"G1100010009501304","G1100010009501",185,163,0,7,7,6,368
"G1100010009501305","G1100010009501",13,165,0,2,2,5,187
"G1100010009501306","G1100010009501",1,52,1,3,3,0,60
"G1100010009501307","G1100010009501",3,70,0,0,0,0,73
"G1100010009501308","G1100010009501",8,69,0,1,1,3,82
"G1100010009501309","G1100010009501",2,85,0,2,2,0,91
"G1100010009501401","G1100010009501",2,219,3,2,2,1,229
"G1100010009501402","G1100010009501",2,88,0,0,0,4,94
"G1100010009501405","G1100010009501",0,89,0,0,0,0,89
"G1100010009501407","G1100010009501",0,57,0,0,0,0,57
"G1100010009501420","G1100010009501",11,302,0,0,0,2,315
"G1100010009503101","G1100010009503",9,87,0,0,0,0,96
"G1100010009503102","G1100010009503",0,117,0,0,0,0,117
"G1100010009503103","G1100010009503",10,185,0,1,1,0,197
"G1100010009503104","G1100010009503",0,76,0,3,3,0,82
"G1100010009503105","G1100010009503",0,100,0,0,0,0,100
"G1100010009503106","G1100010009503",2,116,0,0,0,0,118
"G1100010009503107","G1100010009503",47,271,0,2,2,3,325
"G1100010009503108","G1100010009503",4,45,0,0,0,0,49
"G1100010009503109","G1100010009503",15,85,0,0,0,0,100
"G1100010009503110","G1100010009503",1,29,0,0,0,0,30
"G1100010009503111","G1100010009503",12,67,0,1,1,3,84
"G1100010009503112","G1100010009503",17,66,0,0,0,0,83
"G1100010009503113","G1100010009503",8,85,0,0,0,5,98
"G1100010009503114","G1100010009503",1,74,0,0,0,0,75
"G1100010009503116","G1100010009503",8,72,1,0,0,0,81
"G1100010009503201","G1100010009503",11,83,0,4,4,1,103
"G1100010009503202","G1100010009503",4,30,0,0,0,0,34
"G1100010009503203","G1100010009503",14,57,0,0,0,1,72
"G1100010009503204","G1100010009503",6,88,0,0,0,0,94
"G1100010009503205","G1100010009503",17,67,0,1,1,3,89
"G1100010009503206","G1100010009503",1,7,0,0,0,0,8
"G1100010009503207","G1100010009503",7,39,0,0,0,0,46
"G1100010009503301","G1100010009503",107,78,2,5,5,16,213
"G1100010009503302","G1100010009503",1,19,0,0,0,0,20
"G1100010009503303","G1100010009503",0,96,0,1,1,0,98
"G1100010009503304","G1100010009503",5,67,0,0,0,5,77
"G1100010009503305","G1100010009503",1,28,0,0,0,0,29
"G1100010009503402","G1100010009503",21,3,0,0,0,0,24
"G1100010009503403","G1100010009503",21,0,0,0,0,0,21
"G1100010009503404","G1100010009503",14,68,0,1,1,1,85
"G1100010009503405","G1100010009503",8,68,0,0,0,0,76
"G1100010009503406","G1100010009503",7,43,0,0,0,0,50
"G1100010009503407","G1100010009503",8,77,0,0,0,4,89
"G1100010009503501","G1100010009503",5,46,0,0,0,0,51
"G1100010009503502","G1100010009503",8,43,0,0,0,1,52
"G1100010009503505","G1100010009503",7,80,0,0,0,1,88
"G1100010009503507","G1100010009503",3,21,0,0,0,0,24
"G1100010009503508","G1100010009503",10,24,0,0,0,1,35
"G1100010009503509","G1100010009503",0,22,0,0,0,0,22
"G1100010009503510","G1100010009503",13,87,0,0,0,0,100
"G1100010009505101","G1100010009505",17,179,1,6,6,1,210
"G1100010009505102","G1100010009505",1,53,0,0,0,0,54
"G1100010009505103","G1100010009505",0,27,0,0,0,0,27
"G1100010009505104","G1100010009505",5,60,0,0,0,0,65
"G1100010009505105","G1100010009505",5,99,0,0,0,0,104
"G1100010009505106","G1100010009505",5,71,0,0,0,0,76
"G1100010009505202","G1100010009505",3,111,0,4,4,0,122
"G1100010009505203","G1100010009505",6,82,2,2,2,0,94
"G1100010009505204","G1100010009505",7,106,0,0,0,0,113
"G1100010009505205","G1100010009505",42,140,0,0,0,8,190
"G1100010009505206","G1100010009505",0,8,0,0,0,0,8
"G1100010009505207","G1100010009505",0,4,0,0,0,0,4
"G1100010009505209","G1100010009505",0,42,0,0,0,0,42
"G1100010009505210","G1100010009505",1,20,0,3,3,0,27
"G1100010009505211","G1100010009505",0,12,0,0,0,0,12
"G1100010009505212","G1100010009505",4,39,0,0,0,0,43
"G1100010009505213","G1100010009505",4,6,0,0,0,0,10
"G1100010009505214","G1100010009505",0,11,0,0,0,0,11
"G1100010009505301","G1100010009505",0,13,0,0,0,3,16
"G1100010009505302","G1100010009505",6,151,0,0,0,5,162
"G1100010009505303","G1100010009505",1,11,0,0,0,0,12
"G1100010009505304","G1100010009505",1,71,0,0,0,0,72
"G1100010009505305","G1100010009505",0,19,0,0,0,0,19
"G1100010009505306","G1100010009505",0,59,0,0,0,0,59
"G1100010009505402","G1100010009505",3,176,0,1,1,0,181
"G1100010009505403","G1100010009505",0,40,0,0,0,4,44
"G1100010009505404","G1100010009505",9,22,0,1,1,0,33
"G1100010009505405","G1100010009505",1,187,1,0,0,1,190
"G1100010009505501","G1100010009505",0,110,0,0,0,0,110
"G1100010009505502","G1100010009505",0,48,0,0,0,0,48
"G1100010009505503","G1100010009505",1,75,0,0,0,0,76
"G1100010009505504","G1100010009505",1,93,0,0,0,0,94
"G1100010009505505","G1100010009505",2,120,0,1,1,1,125
"G1100010009505507","G1100010009505",2,68,0,0,0,0,70
"G1100010009505508","G1100010009505",2,50,0,0,0,0,52
"G1100010009505509","G1100010009505",2,173,0,1,1,5,182
"G1100010009505510","G1100010009505",1,79,1,0,0,10,91
"G1100010009505601","G1100010009505",5,29,0,0,0,0,34
"G1100010009505602","G1100010009505",0,44,0,0,0,0,44
"G1100010009505603","G1100010009505",1,24,0,0,0,0,25
"G1100010009505604","G1100010009505",1,41,0,0,0,1,43
"G1100010009505605","G1100010009505",1,40,0,1,1,0,43
"G1100010009505606","G1100010009505",3,55,0,0,0,0,58
"G1100010009505607","G1100010009505",2,32,0,0,0,0,34
"G1100010009505611","G1100010009505",0,19,0,0,0,0,19
"G1100010009507101","G1100010009507",4,287,0,0,0,4,295
"G1100010009507102","G1100010009507",1,102,1,0,0,0,104
"G1100010009507103","G1100010009507",4,342,0,0,0,5,351
"G1100010009507105","G1100010009507",3,168,0,0,0,0,171
"G1100010009507106","G1100010009507",5,248,0,2,2,0,257
"G1100010009507107","G1100010009507",2,74,0,0,0,0,76
"G1100010009507108","G1100010009507",0,14,0,0,0,0,14
"G1100010009507109","G1100010009507",0,106,0,0,0,0,106
"G1100010009507110","G1100010009507",0,3,0,0,0,0,3
"G1100010009507112","G1100010009507",0,144,2,0,0,0,146
"G1100010009507113","G1100010009507",4,155,0,0,0,1,160
"G1100010009508201","G1100010009508",0,16,0,0,0,0,16
"G1100010009508202","G1100010009508",11,39,0,0,0,0,50
"G1100010009508203","G1100010009508",2,61,0,0,0,7,70
"G1100010009508204","G1100010009508",3,364,1,0,0,0,368
"G1100010009508205","G1100010009508",7,406,1,2,2,2,420
"G1100010009508206","G1100010009508",2,93,0,1,1,0,97
"G1100010009508207","G1100010009508",4,121,0,0,0,0,125
"G1100010009508208","G1100010009508",7,291,0,0,0,4,302
"G1100010009508209","G1100010009508",0,87,1,0,0,0,88
"G1100010009508301","G1100010009508",0,56,0,0,0,0,56
"G1100010009508302","G1100010009508",2,74,0,0,0,0,76
"G1100010009508303","G1100010009508",3,95,0,1,1,0,100
"G1100010009508304","G1100010009508",1,155,2,0,0,1,159
"G1100010009508305","G1100010009508",2,102,0,0,0,0,104
"G1100010009508306","G1100010009508",2,283,1,0,0,0,286
"G1100010009508307","G1100010009508",3,71,0,0,0,0,74
"G1100010009508308","G1100010009508",3,70,0,0,0,0,73
"G1100010009508402","G1100010009508",4,210,0,0,0,0,214
"G1100010009508403","G1100010009508",1,99,1,0,0,0,101
"G1100010009508408","G1100010009508",0,207,0,0,0,0,207
"G1100010009508409","G1100010009508",1,95,0,2,2,0,100
"G1100010009509101","G1100010009509",3,183,0,0,0,0,186
"G1100010009509102","G1100010009509",4,136,0,0,0,4,144
"G1100010009509103","G1100010009509",0,143,0,0,0,0,143
"G1100010009509104","G1100010009509",1,161,0,0,0,0,162
"G1100010009509105","G1100010009509",3,112,0,0,0,0,115
"G1100010009509106","G1100010009509",0,47,0,0,0,0,47
"G1100010009509107","G1100010009509",1,153,0,0,0,0,154
"G1100010009509108","G1100010009509",13,225,4,0,0,0,242
"G1100010009509201","G1100010009509",0,84,0,0,0,0,84
"G1100010009509202","G1100010009509",0,72,0,0,0,1,73
"G1100010009509203","G1100010009509",1,65,0,0,0,0,66
"G1100010009509204","G1100010009509",1,41,0,0,0,0,42
"G1100010009509205","G1100010009509",2,45,0,0,0,0,47
"G1100010009509206","G1100010009509",2,129,3,0,0,0,134
"G1100010009509207","G1100010009509",3,105,1,3,3,2,117
"G1100010009509208","G1100010009509",4,82,0,0,0,0,86
"G1100010009509209","G1100010009509",9,148,0,3,3,0,163
"G1100010009509210","G1100010009509",10,94,0,7,7,0,118
"G1100010009509211","G1100010009509",4,128,0,0,0,1,133
"G1100010009509212","G1100010009509",4,131,0,0,0,0,135
"G1100010009509801","G1100010009509",1,114,1,0,0,0,116
"G1100010009509802","G1100010009509",0,140,0,4,4,5,153
"G1100010009509803","G1100010009509",2,168,1,0,0,0,171
"G1100010009509804","G1100010009509",5,437,0,0,0,7,449
"G1100010009540301","G1100010009540",21,27,0,0,0,0,48
"G1100010009540302","G1100010009540",2,9,0,0,0,0,11
"G1100010009540304","G1100010009540",5,45,0,4,4,6,64
"G1100010009540305","G1100010009540",10,56,0,0,0,0,66
"G1100010009540306","G1100010009540",12,38,0,0,0,6,56
"G1100010009540307","G1100010009540",20,47,0,1,1,0,69
"G1100010009540401","G1100010009540",5,36,0,0,0,0,41
"G1100010009540402","G1100010009540",26,70,3,0,0,5,104
"G1100010009540403","G1100010009540",0,16,0,0,0,6,22
"G1100010009540404","G1100010009540",31,28,0,0,0,2,61
"G1100010009540405","G1100010009540",36,43,1,4,4,0,88
"G1100010009540406","G1100010009540",40,56,0,6,6,4,112
"G1100010009540501","G1100010009540",7,42,0,0,0,0,49
"G1100010009540502","G1100010009540",15,23,0,0,0,0,38
"G1100010009540503","G1100010009540",17,29,0,0,0,0,46
"G1100010009540504","G1100010009540",0,15,0,0,0,0,15
"G1100010009540505","G1100010009540",71,75,1,7,7,1,162
"G1100010009540506","G1100010009540",27,60,0,5,5,6,103
"G1100010009540601","G1100010009540",46,72,0,0,0,1,119
"G1100010009540602","G1100010009540",20,81,0,1,1,3,106
"G1100010009540603","G1100010009540",31,98,0,0,0,2,131
"G1100010009540604","G1100010009540",30,49,0,1,1,2,83
"G1100010009540605","G1100010009540",34,86,0,4,4,4,132
"G1100010009540606","G1100010009540",102,177,0,0,0,21,300
"G1100010009540701","G1100010009540",135,833,0,21,21,9,1019
"G1100010009540703","G1100010009540",20,42,1,2,2,2,69
"G1100010009540704","G1100010009540",11,56,0,1,1,1,70
"G1100010009540705","G1100010009540",16,46,0,1,1,0,64
"G1100010009540706","G1100010009540",5,30,0,0,0,0,35
"G1100010009601101","G1100010009601",0,186,1,0,0,0,187
"G1100010009601102","G1100010009601",11,57,0,0,0,0,68
"G1100010009601103","G1100010009601",0,60,0,0,0,0,60
"G1100010009601104","G1100010009601",0,53,0,0,0,0,53
"G1100010009601106","G1100010009601",0,101,0,0,0,0,101
"G1100010009601108","G1100010009601",0,46,0,0,0,0,46
"G1100010009601109","G1100010009601",0,32,0,0,0,0,32
"G1100010009601110","G1100010009601",2,58,0,0,0,0,60
"G1100010009601111","G1100010009601",0,63,4,0,0,0,67
"G1100010009601112","G1100010009601",0,6,0,0,0,0,6
"G1100010009601117","G1100010009601",0,3,0,0,0,0,3
"G1100010009601118","G1100010009601",2,65,0,0,0,0,67
"G1100010009601121","G1100010009601",0,64,0,0,0,0,64
"G1100010009601201","G1100010009601",0,2,0,0,0,0,2
"G1100010009601202","G1100010009601",0,28,0,0,0,0,28
"G1100010009601203","G1100010009601",0,51,0,0,0,0,51
"G1100010009601206","G1100010009601",0,23,0,0,0,0,23
"G1100010009601207","G1100010009601",0,37,0,0,0,0,37
"G1100010009601208","G1100010009601",1,39,0,0,0,0,40
"G1100010009601209","G1100010009601",0,52,0,1,1,0,54
"G1100010009601210","G1100010009601",0,48,0,0,0,0,48
"G1100010009601211","G1100010009601",0,29,0,0,0,0,29
"G1100010009601212","G1100010009601",0,31,0,0,0,0,31
"G1100010009601214","G1100010009601",0,116,1,0,0,0,117
"G1100010009601215","G1100010009601",0,74,0,0,0,0,74
"G1100010009601216","G1100010009601",0,37,0,0,0,0,37
"G1100010009601218","G1100010009601",0,11,0,0,0,0,11
"G1100010009601219","G1100010009601",0,3,0,1,1,0,5
"G1100010009602302","G1100010009602",0,100,0,0,0,0,100
"G1100010009602309","G1100010009602",11,2356,1,0,0,4,2372
"G1100010009603101","G1100010009603",0,58,1,0,0,0,59
"G1100010009603102","G1100010009603",2,253,6,1,1,0,263
"G1100010009603103","G1100010009603",0,61,5,0,0,3,69
"G1100010009603104","G1100010009603",2,107,0,0,0,2,111
"G1100010009603105","G1100010009603",1,99,0,0,0,6,106
"G1100010009603106","G1100010009603",0,186,0,1,1,0,188
"G1100010009603108","G1100010009603",0,148,0,0,0,5,153
"G1100010009603109","G1100010009603",6,694,3,0,0,1,704
"G1100010009603202","G1100010009603",0,173,0,1,1,3,178
"G1100010009603203","G1100010009603",2,68,0,0,0,0,70
"G1100010009603204","G1100010009603",0,59,0,0,0,1,60
"G1100010009603205","G1100010009603",1,194,0,0,0,0,195
"G1100010009603206","G1100010009603",1,202,0,0,0,0,203
"G1100010009603207","G1100010009603",0,35,0,1,1,0,37
"G1100010009603210","G1100010009603",0,32,0,0,0,0,32
"G1100010009603301","G1100010009603",2,284,0,0,0,3,289
"G1100010009603302","G1100010009603",0,75,0,0,0,1,76
"G1100010009603303","G1100010009603",0,44,0,0,0,0,44
"G1100010009603306","G1100010009603",1,90,1,0,0,0,92
"G1100010009603322","G1100010009603",3,108,0,0,0,2,113
"G1100010009603323","G1100010009603",3,284,0,0,0,3,290
"G1100010009604402","G1100010009604",1,171,0,0,0,0,172
"G1100010009604403","G1100010009604",0,122,0,0,0,3,125
"G1100010009604404","G1100010009604",2,177,0,0,0,3,182
"G1100010009604405","G1100010009604",1,254,0,0,0,0,255
"G1100010009604406","G1100010009604",0,116,0,1,1,1,119
"G1100010009604407","G1100010009604",0,111,1,0,0,0,112
"G1100010009604408","G1100010009604",6,108,0,0,0,0,114
"G1100010009604409","G1100010009604",0,168,0,0,0,0,168
"G1100010009604410","G1100010009604",0,101,0,0,0,3,104
"G1100010009604502","G1100010009604",0,111,0,0,0,8,119
"G1100010009604503","G1100010009604",1,101,0,0,0,0,102
"G1100010009604504","G1100010009604",1,105,0,0,0,0,106
"G1100010009604505","G1100010009604",1,135,0,0,0,0,136
"G1100010009604506","G1100010009604",0,141,0,0,0,0,141
"G1100010009604507","G1100010009604",0,192,1,0,0,0,193
"G1100010009604508","G1100010009604",0,38,0,0,0,0,38
"G1100010009604509","G1100010009604",0,30,0,0,0,0,30
"G1100010009604520","G1100010009604",0,49,0,0,0,0,49
"G11000100097101","G11000100097",0,47,0,0,0,0,47
"G11000100097102","G11000100097",0,788,2,0,0,4,794
"G11000100097103","G11000100097",3,1390,3,0,0,4,1400
"G11000100097104","G11000100097",0,180,0,0,0,0,180
"G11000100097106","G11000100097",0,178,0,0,0,3,181
"G11000100097107","G11000100097",0,104,0,0,0,0,104
"G11000100097108","G11000100097",0,172,0,0,0,0,172
"G11000100097109","G11000100097",0,206,0,0,0,0,206
"G11000100097201","G11000100097",4,1314,5,2,2,3,1330
"G1100010009803201","G1100010009803",2,140,0,0,0,0,142
"G1100010009803202","G1100010009803",1,127,0,0,0,0,128
"G1100010009803203","G1100010009803",0,45,0,0,0,3,48
"G1100010009803204","G1100010009803",0,115,0,0,0,0,115
"G1100010009803205","G1100010009803",0,70,0,0,0,0,70
"G1100010009803206","G1100010009803",2,87,0,0,0,3,92
"G1100010009803207","G1100010009803",0,229,0,1,1,5,236
"G1100010009803301","G1100010009803",8,309,1,0,0,0,318
"G1100010009803302","G1100010009803",5,136,0,2,2,1,146
"G1100010009803303","G1100010009803",1,275,0,0,0,3,279
"G1100010009803304","G1100010009803",0,170,0,0,0,6,176
"G1100010009803305","G1100010009803",7,334,0,0,0,6,347
"G1100010009803306","G1100010009803",2,47,0,0,0,0,49
"G1100010009803401","G1100010009803",2,109,0,0,0,0,111
"G1100010009803402","G1100010009803",3,125,0,0,0,0,128
"G1100010009803403","G1100010009803",3,195,0,2,2,2,204
"G1100010009803404","G1100010009803",0,60,0,0,0,0,60
"G1100010009803405","G1100010009803",0,83,0,0,0,2,85
"G1100010009803406","G1100010009803",1,76,0,0,0,0,77
"G1100010009804101","G1100010009804",6,416,3,3,3,2,433
"G1100010009804102","G1100010009804",1,1607,0,1,1,10,1620
"G1100010009804103","G1100010009804",0,74,0,0,0,0,74
"G1100010009804104","G1100010009804",0,46,0,0,0,0,46
"G1100010009804105","G1100010009804",0,113,0,0,0,0,113
"G1100010009804106","G1100010009804",2,112,0,1,1,0,116
"G1100010009804107","G1100010009804",0,171,0,0,0,0,171
"G1100010009804109","G1100010009804",0,213,0,0,0,0,213
"G1100010009805202","G1100010009805",3,121,0,0,0,1,125
"G1100010009805301","G1100010009805",4,99,2,0,0,0,105
"G1100010009805302","G1100010009805",23,104,1,2,2,0,132
"G1100010009805303","G1100010009805",11,428,0,0,0,3,442
"G1100010009805304","G1100010009805",2,150,0,0,0,0,152
"G1100010009805305","G1100010009805",1,154,0,0,0,0,155
"G1100010009805306","G1100010009805",0,185,1,0,0,1,187
"G1100010009805307","G1100010009805",3,48,0,4,4,2,61
"G1100010009806101","G1100010009806",8,1156,1,0,0,19,1184
"G1100010009806102","G1100010009806",0,55,0,0,0,2,57
"G1100010009806103","G1100010009806",3,158,0,0,0,0,161
"G1100010009806107","G1100010009806",0,301,0,0,0,0,301
"G1100010009806108","G1100010009806",0,395,2,0,0,5,402
"G1100010009806109","G1100010009806",1,75,0,0,0,0,76
"G1100010009806110","G1100010009806",0,75,0,0,0,1,76
"G1100010009806111","G1100010009806",2,100,0,0,0,0,102
"G1100010009806201","G1100010009806",4,426,3,0,0,7,440
"G1100010009806202","G1100010009806",2,566,1,0,0,1,570
"G1100010009806203","G1100010009806",16,1056,0,0,0,2,1074
"G1100010009806205","G1100010009806",5,1460,2,1,1,9,1478
"G1100010009807104","G1100010009807",16,116,0,0,0,0,132
"G1100010009807105","G1100010009807",0,150,0,0,0,0,150
"G1100010009807106","G1100010009807",3,30,0,0,0,6,39
"G1100010009807202","G1100010009807",2,64,0,0,0,0,66
"G1100010009807203","G1100010009807",1,56,0,0,0,0,57
"G1100010009807204","G1100010009807",7,110,0,0,0,4,121
"G1100010009807205","G1100010009807",8,110,0,1,1,0,120
"G1100010009807206","G1100010009807",5,62,1,1,1,0,70
"G1100010009807207","G1100010009807",5,116,0,8,8,4,141
"G1100010009807301","G1100010009807",5,270,0,7,7,6,295
"G1100010009807302","G1100010009807",9,279,0,0,0,0,288
"G1100010009807303","G1100010009807",0,576,0,1,1,0,578
"G1100010009807305","G1100010009807",1,251,0,0,0,0,252
"G1100010009807306","G1100010009807",8,288,0,0,0,1,297
"G1100010009807307","G1100010009807",0,34,0,0,0,0,34
"G1100010009807308","G1100010009807",5,389,3,0,0,4,401
"G1100010009807311","G1100010009807",3,347,0,6,6,5,367
"G1100010009808401","G1100010009808",1,182,0,0,0,0,183
"G1100010009808403","G1100010009808",5,671,0,1,1,6,684
"G1100010009808404","G1100010009808",3,142,0,0,0,2,147
"G1100010009808405","G1100010009808",2,963,0,1,1,12,979
"G1100010009808406","G1100010009808",6,243,0,0,0,12,261
"G1100010009808407","G1100010009808",0,124,0,0,0,0,124
"G1100010009809101","G1100010009809",263,1232,5,9,9,31,1549
"G1100010009810101","G1100010009810",3,241,0,0,0,0,244
"G1100010009810101A","G1100010009810",0,0,0,0,0,0,0
"G1100010009810105","G1100010009810",5,1121,0,1,1,2,1130
"G1100010009810106","G1100010009810",5,730,0,0,0,66,801
"G1100010009810107","G1100010009810",0,128,0,0,0,0,128
"G1100010009810108","G1100010009810",0,241,0,0,0,0,241
"G1100010009810109","G1100010009810",0,110,0,0,0,0,110
"G1100010009820110","G1100010009820",1,274,0,0,0,0,275
"G1100010009820111","G1100010009820",0,581,3,1,1,1,587
"G1100010009820201","G1100010009820",0,100,0,2,2,2,106
"G1100010009820203","G1100010009820",0,464,4,0,0,0,468
"G1100010009820204","G1100010009820",3,193,0,0,0,0,196
"G1100010009820206","G1100010009820",1,572,6,0,0,1,580
"G1100010009901102","G1100010009901",3,5,0,0,0,0,8
"G1100010009901301","G1100010009901",24,365,1,0,0,0,390
"G1100010009901302","G1100010009901",11,37,0,0,0,0,48
"G1100010009901308","G1100010009901",10,50,0,0,0,4,64
"G1100010009901309","G1100010009901",1,76,0,0,0,1,78
"G1100010009901310","G1100010009901",21,91,0,0,0,0,112
"G1100010009901311","G1100010009901",15,44,0,7,7,1,74
"G1100010009901401","G1100010009901",27,148,1,0,0,0,176
"G1100010009901402","G1100010009901",2,80,0,0,0,0,82
"G1100010009901403","G1100010009901",0,33,0,0,0,0,33
"G1100010009901404","G1100010009901",6,83,0,0,0,0,89
"G1100010009901405","G1100010009901",20,74,0,0,0,3,97
"G1100010009901406","G1100010009901",11,62,0,0,0,0,73
"G1100010009901407","G1100010009901",1,74,0,0,0,0,75
"G1100010009901501","G1100010009901",0,12,0,0,0,0,12
"G1100010009901502","G1100010009901",2,39,0,0,0,0,41
"G1100010009901503","G1100010009901",4,64,0,1,1,0,70
"G1100010009901505","G1100010009901",3,68,0,0,0,0,71
"G1100010009901507","G1100010009901",4,32,1,0,0,0,37
"G1100010009901509","G1100010009901",1,27,0,0,0,0,28
"G1100010009901511","G1100010009901",2,38,0,0,0,0,40
"G1100010009901513","G1100010009901",5,79,0,0,0,3,87
"G1100010009901601","G1100010009901",3,85,0,1,1,0,90
"G1100010009901602","G1100010009901",5,104,0,0,0,0,109
"G1100010009901603","G1100010009901",1,59,0,0,0,1,61
"G1100010009901604","G1100010009901",3,112,0,0,0,0,115
"G1100010009901605","G1100010009901",0,31,3,0,0,0,34
"G1100010009901606","G1100010009901",1,40,0,0,0,0,41
"G1100010009901607","G1100010009901",3,62,0,0,0,0,65
"G1100010009901608","G1100010009901",0,20,0,0,0,5,25
"G1100010009901609","G1100010009901",13,82,0,0,0,0,95
"G1100010009901610","G1100010009901",4,118,0,0,0,0,122
"G1100010009901611","G1100010009901",8,55,0,0,0,0,63
"G1100010009901612","G1100010009901",6,27,0,0,0,0,33
"G1100010009901613","G1100010009901",4,3,0,0,0,0,7
"G1100010009902101","G1100010009902",3,12,0,0,0,0,15
"G1100010009902103","G1100010009902",1,24,0,0,0,0,25
"G1100010009902109","G1100010009902",5,56,0,0,0,3,64
"G1100010009902114","G1100010009902",1,41,0,0,0,0,42
"G1100010009902117","G1100010009902",5,337,0,0,0,1,343
"G1100010009902201","G1100010009902",0,144,0,0,0,0,144
"G1100010009902202","G1100010009902",6,132,2,0,0,0,140
"G1100010009902206","G1100010009902",4,120,0,0,0,0,124
"G1100010009902207","G1100010009902",0,63,1,0,0,0,64
"G1100010009902208","G1100010009902",5,224,7,2,2,0,240
"G1100010009902209","G1100010009902",0,81,0,0,0,0,81
"G1100010009902210","G1100010009902",4,431,4,0,0,0,439
"G1100010009902211","G1100010009902",0,179,0,0,0,0,179
"G1100010009902212","G1100010009902",3,155,0,0,0,5,163
"G1100010009902213","G1100010009902",12,309,0,0,0,4,325
"G1100010009902215","G1100010009902",8,286,0,0,0,2,296
"G1100010009902217","G1100010009902",3,63,2,0,0,0,68
"G1100010009902218","G1100010009902",3,166,0,0,0,0,169
"G1100010009902219","G1100010009902",6,163,0,0,0,1,170
"G1100010009902220","G1100010009902",3,112,0,0,0,0,115
"G1100010009902301","G1100010009902",2,68,0,0,0,0,70
"G1100010009902401","G1100010009902",0,20,0,0,0,0,20
"G1100010009903101","G1100010009903",0,1424,1,0,0,0,1425
"G1100010009903102","G1100010009903",0,486,1,0,0,4,491
"G1100010009903103","G1100010009903",0,98,0,0,0,1,99
"G1100010009903104","G1100010009903",0,359,0,0,0,5,364
"G1100010009903108","G1100010009903",0,70,0,0,0,0,70
"G1100010009903109","G1100010009903",0,65,0,0,0,0,65
"G1100010009903110","G1100010009903",0,190,0,0,0,0,190
"G1100010009903507","G1100010009903",0,149,0,0,0,0,149
"G1100010009903508","G1100010009903",2,93,0,0,0,0,95
"G1100010009903509","G1100010009903",0,103,0,0,0,0,103
"G1100010009903514","G1100010009903",0,85,0,0,0,0,85
"G1100010009904313","G1100010009904",0,188,0,0,0,1,189
"G1100010009904320","G1100010009904",1,857,0,0,0,5,863
"G1100010009904401","G1100010009904",2,232,0,0,0,0,234
"G1100010009904402","G1100010009904",2,137,0,0,0,0,139
"G1100010009904403","G1100010009904",0,147,0,0,0,4,151
"G1100010009904404","G1100010009904",0,227,2,0,0,1,230
"G1100010009904501","G1100010009904",0,2,0,0,0,0,2
"G1100010009904503","G1100010009904",0,45,1,0,0,0,46
"G1100010009904504","G1100010009904",1,89,0,0,0,0,90
"G1100010009904511","G1100010009904",0,111,1,0,0,0,112
"G1100010009904601","G1100010009904",2,41,0,0,0,0,43
"G1100010009904602","G1100010009904",0,218,0,0,0,0,218
"G1100010009904603","G1100010009904",0,113,0,0,0,0,113
"G1100010009904604","G1100010009904",0,81,1,0,0,0,82
"G1100010009904606","G1100010009904",0,33,0,0,0,0,33
"G1100010009904607","G1100010009904",0,23,0,0,0,0,23
"G1100010009904608","G1100010009904",0,5,0,0,0,0,5
"G1100010009904609","G1100010009904",0,292,0,0,0,0,292
"G1100010009904610","G1100010009904",0,457,0,0,0,0,457
"G1100010009905201","G1100010009905",0,246,0,0,0,0,246
"G1100010009905202","G1100010009905",0,155,1,0,0,0,156
"G1100010009905203","G1100010009905",0,110,0,0,0,0,110
"G1100010009905204","G1100010009905",1,117,0,0,0,0,118
"G1100010009905205","G1100010009905",0,231,1,0,0,0,232
"G1100010009905206","G1100010009905",0,186,0,0,0,0,186
"G1100010009905207","G1100010009905",0,5,0,0,0,0,5
"G1100010009905301","G1100010009905",3,190,0,0,0,0,193
"G1100010009905303","G1100010009905",1,238,0,0,0,0,239
"G1100010009905304","G1100010009905",1,120,0,0,0,0,121
"G1100010009905305","G1100010009905",0,66,0,0,0,1,67
"G1100010009905309","G1100010009905",0,106,0,0,0,0,106
"G1100010009905311","G1100010009905",0,75,0,0,0,0,75
"G1100010009905312","G1100010009905",0,55,0,0,0,0,55
"G1100010009905401","G1100010009905",0,43,0,0,0,0,43
"G1100010009905402","G1100010009905",0,72,0,0,0,2,74
"G1100010009905403","G1100010009905",0,110,0,0,0,2,112
"G1100010009905404","G1100010009905",2,92,0,0,0,0,94
"G1100010009905405","G1100010009905",1,110,0,0,0,0,111
"G1100010009905407","G1100010009905",0,176,0,0,0,0,176
"G1100010009905411","G1100010009905",0,121,0,0,0,0,121
"G1100010009905501","G1100010009905",0,122,0,1,1,1,125
"G1100010009905502","G1100010009905",0,97,0,0,0,0,97
"G1100010009905503","G1100010009905",1,155,0,0,0,0,156
"G1100010009905504","G1100010009905",1,114,0,0,0,0,115
"G1100010009905506","G1100010009905",0,36,0,1,1,0,38
"G1100010009906101","G1100010009906",5,317,0,0,0,0,322
"G1100010009906102","G1100010009906",0,184,0,0,0,0,184
"G1100010009906103","G1100010009906",1,199,0,0,0,0,200
"G1100010009906104","G1100010009906",1,130,0,0,0,0,131
"G1100010009906105","G1100010009906",0,431,0,0,0,4,435
"G1100010009906106","G1100010009906",0,192,0,0,0,0,192
"G1100010009906202","G1100010009906",1,282,0,0,0,10,293
"G1100010009906203","G1100010009906",2,193,0,0,0,0,195
"G1100010009907202","G1100010009907",3,609,0,0,0,0,612
"G1100010009907203","G1100010009907",1,437,0,0,0,0,438
"G1100010009907204","G1100010009907",1,551,4,0,0,3,559
"G1100010009907205","G1100010009907",1,65,0,0,0,0,66
"G1100010009907206","G1100010009907",0,58,0,0,0,0,58
"G1100010009907207","G1100010009907",0,179,0,0,0,0,179
"G1100010009907208","G1100010009907",0,245,0,1,1,0,247
"G1100010009907209","G1100010009907",2,292,0,0,0,0,294
"G1100010009907210","G1100010009907",0,235,0,0,0,0,235
"G1100010009907211","G1100010009907",1,272,0,0,0,2,275
"G1100010009907212","G1100010009907",0,51,0,0,0,0,51
"G1100010009907213","G1100010009907",1,83,0,0,0,0,84
