"GISJOIN_T","WHITE","BLACK","AM","ASIAN","OTHER","HISPANIC","POP"
"G11000100001",4175,147,3,145,145,233,4848
"G1100010000201",2860,371,7,315,315,266,4134
"G1100010000202",3267,60,6,121,121,181,3756
"G1100010000310",5046,186,8,208,208,284,5940
"G11000100004",1073,48,5,78,78,114,1396
"G1100010000501",2332,143,1,107,107,183,2873
"G1100010000502",3205,120,5,132,132,350,3944
"G11000100006",3954,408,5,157,157,428,5109
"G1100010000701",3658,204,6,174,174,535,4751
"G1100010000720",2569,187,2,229,229,322,3538
"G1100010000801",5205,207,4,189,189,319,6113
"G1100010000802",2308,102,7,110,110,163,2800
"G1100010000901",5779,285,7,341,341,416,7169
"G1100010000902",1732,91,0,64,64,68,2019
"G1100010001001",5452,258,2,246,246,356,6560
"G1100010001002",2701,263,6,250,250,304,3774
"G11000100011",3868,161,5,185,185,189,4593
"G11000100012",3936,261,9,213,213,401,5033
"G1100010001301",3139,266,5,128,128,152,3818
"G1100010001302",4838,419,11,271,271,419,6229
"G1100010001401",2607,152,4,148,148,160,3219
"G1100010001402",2289,313,2,105,105,151,2965
"G11000100015",4694,596,9,118,118,140,5675
"G11000100016",1144,3185,8,57,57,76,4527
"G1100010001701",317,2473,7,66,66,119,3048
"G1100010001702",489,1978,14,32,32,88,2633
"G1100010001801",358,313,6,15,15,71,778
"G1100010001803",211,2318,9,18,18,185,2759
"G1100010001804",106,3616,21,15,15,462,4235
"G1100010001901",111,4109,11,18,18,133,4400
"G1100010001902",123,2335,8,7,7,31,2511
"G1100010002001",439,1689,13,45,45,229,2460
"G1100010002002",387,3369,10,34,34,179,4013
"G1100010002101",56,4985,13,34,34,189,5311
"G1100010002102",76,4827,14,23,23,143,5106
"G1100010002201",58,3387,9,9,9,183,3655
"G1100010002202",54,3104,9,3,3,126,3299
"G1100010002301",59,3193,2,7,7,80,3348
"G1100010002302",2482,1753,9,42,42,130,4458
"G11000100024",113,3539,2,19,19,205,3897
"G1100010002501",212,1918,4,8,8,242,2392
"G1100010002502",137,3958,6,21,21,705,4848
"G11000100026",693,1499,4,42,42,50,2330
"G1100010002701",1664,1957,6,264,264,1031,5186
"G1100010002702",2212,1910,14,110,110,1971,6327
"G1100010002801",147,2143,5,83,83,1032,3493
"G1100010002802",325,1935,10,225,225,2256,4976
"G11000100029",93,3361,6,14,14,609,4097
"G11000100030",153,2154,9,7,7,316,2646
"G11000100031",42,2505,5,8,8,347,2915
"G11000100032",58,4449,12,13,13,320,4865
"G1100010003301",203,2825,6,15,15,52,3116
"G1100010003302",96,1849,1,7,7,38,1998
"G11000100034",89,4341,18,26,26,104,4604
"G11000100035",42,2018,4,4,4,151,2223
"G11000100036",214,3620,10,16,16,406,4282
"G11000100037",240,3915,13,56,56,1192,5472
"G11000100038",1302,2165,10,81,81,932,4571
"G11000100039",2063,1397,14,150,150,947,4721
"G1100010004001",2451,171,9,78,78,312,3099
"G1100010004002",1888,609,13,108,108,391,3117
"G11000100041",2318,119,6,142,142,208,2935
"G1100010004201",2074,920,8,95,95,549,3741
"G1100010004202",1840,305,13,130,130,312,2730
"G11000100043",963,1770,10,43,43,488,3317
"G11000100044",239,1192,0,19,19,294,1763
"G11000100045",79,1064,5,15,15,39,1217
"G11000100046",143,3298,8,27,27,139,3642
"G11000100047",164,4252,23,81,81,33,4634
"G1100010004801",130,1900,1,40,40,82,2193
"G1100010004802",220,2658,1,132,132,78,3221
"G1100010004901",190,1714,7,14,14,68,2007
"G1100010004902",174,972,6,16,16,402,1586
"G11000100050",1374,3818,20,209,209,1014,6644
"G11000100051",557,298,3,62,62,75,1057
"G1100010005210",2209,1673,12,183,183,392,4652
"G1100010005220",296,171,1,92,92,179,831
"G1100010005301",3245,571,9,265,265,972,5327
"G1100010005302",150,17,0,7,7,10,191
"G1100010005401",840,80,5,80,80,81,1166
"G1100010005402",2,0,0,0,0,0,2
"G1100010005501",2142,277,8,159,159,155,2900
"G1100010005502",1177,37,4,33,33,75,1359
"G11000100056",3859,243,10,265,265,279,4921
"G1100010005701",4285,249,9,423,423,182,5571
"G1100010005702",8,6,0,0,0,2,16
"G11000100058",67,154,3,519,519,44,1306
"G11000100059",204,1637,8,39,39,67,1994
"G1100010006001",884,998,9,54,54,116,2115
"G1100010006020",5,771,0,0,0,15,791
"G11000100061",999,881,5,87,87,82,2141
"G1100010006201",47,0,0,1,1,3,52
"G1100010006202",32,17,0,0,0,6,55
"G1100010006301",1813,1724,14,54,54,105,3764
"G1100010006302",266,55,1,5,5,23,355
"G1100010006410",44,2419,10,8,8,35,2524
"G1100010006510",2042,239,3,54,54,56,2448
"G11000100066",1583,109,8,39,39,52,1830
"G1100010006710",2315,1041,9,48,48,64,3525
"G1100010006801",161,2199,1,10,10,47,2428
"G1100010006802",287,2010,4,20,20,33,2374
"G1100010006804",166,2880,9,7,7,118,3187
"G11000100069",775,1213,12,28,28,48,2104
"G1100010007010",1535,472,13,46,46,83,2195
"G11000100071",306,2448,11,24,24,87,2900
"G11000100072",359,1704,5,5,5,14,2092
"G1100010007301",4223,2603,33,384,384,515,8142
"G1100010007302",138,3968,7,26,26,31,4196
"G1100010007304",49,4372,10,9,9,32,4481
"G1100010007308",90,610,1,1,1,7,710
"G1100010007401",11,2664,2,2,2,4,2685
"G1100010007404",11,4093,5,1,1,4,4115
"G1100010007406",6,2382,2,0,0,13,2403
"G1100010007407",11,3104,2,4,4,23,3148
"G1100010007408",40,3001,0,0,0,28,3069
"G1100010007409",13,2935,1,13,13,17,2992
"G1100010007430",5,2423,1,5,5,15,2454
"G1100010007502",80,4258,11,3,3,40,4395
"G1100010007503",82,2887,0,23,23,24,3039
"G1100010007504",79,2567,2,9,9,14,2680
"G1100010007601",210,4944,11,16,16,38,5235
"G1100010007603",749,3555,4,36,36,116,4496
"G1100010007604",233,3976,8,12,12,57,4298
"G1100010007605",72,3774,4,7,7,19,3883
"G1100010007703",41,5525,11,4,4,83,5668
"G1100010007707",38,4127,2,6,6,18,4197
"G1100010007708",27,2845,6,1,1,12,2892
"G1100010007709",97,2192,3,5,5,41,2343
"G1100010007803",15,4030,7,4,4,18,4078
"G1100010007804",34,3557,11,3,3,17,3625
"G1100010007807",14,2150,10,2,2,35,2213
"G1100010007808",13,4700,10,10,10,27,4770
"G1100010007809",11,2779,2,1,1,8,2802
"G1100010007860",18,2338,10,4,4,12,2386
"G1100010007901",61,3787,1,6,6,24,3885
"G1100010007903",19,1966,6,2,2,22,2017
"G1100010008001",484,2417,3,21,21,18,2964
"G1100010008002",845,2671,8,13,13,40,3590
"G1100010008110",1424,1190,4,43,43,72,2776
"G11000100082",2363,195,8,55,55,69,2745
"G1100010008301",1300,955,4,35,35,51,2380
"G1100010008302",1024,869,6,17,17,48,1981
"G1100010008402",553,2109,11,23,23,66,2785
"G1100010008410",65,1614,1,5,5,26,1716
"G1100010008510",148,3414,8,22,22,73,3687
"G11000100086",7,141,0,0,0,9,157
"G1100010008701",43,2709,4,16,16,30,2818
"G1100010008702",31,2018,2,2,2,42,2097
"G1100010008802",37,4680,5,8,8,42,4780
"G1100010008803",453,1636,0,40,40,47,2216
"G1100010008804",15,3052,5,8,8,14,3102
"G1100010008903",14,3306,6,13,13,18,3370
"G1100010008904",20,3794,6,0,0,37,3857
"G1100010009001",30,2108,4,3,3,34,2182
"G1100010009002",44,1378,1,9,9,19,1460
"G1100010009102",42,4767,10,5,5,20,4849
"G1100010009110",187,3327,18,9,9,64,3614
"G1100010009203",100,3022,4,11,11,72,3220
"G1100010009210",669,991,1,20,20,66,1767
"G1100010009240",35,2340,4,3,3,44,2429
"G1100010009301",714,2662,6,69,69,128,3648
"G1100010009302",60,1533,5,4,4,34,1640
"G1100010009410",248,4296,10,15,15,54,4638
"G1100010009501",2077,3523,25,71,71,170,5937
"G1100010009503",433,2716,3,19,19,45,3235
"G1100010009505",145,2919,5,20,20,39,3148
"G1100010009507",23,1643,3,2,2,10,1683
"G1100010009508",58,2995,7,6,6,14,3086
"G1100010009509",73,3143,10,17,17,20,3280
"G1100010009540",795,2285,6,58,58,81,3283
"G1100010009601",16,1375,6,2,2,0,1401
"G1100010009602",11,2456,1,0,0,4,2472
"G1100010009603",24,3254,16,4,4,30,3332
"G1100010009604",13,2230,2,1,1,18,2265
"G11000100097",7,4379,10,2,2,14,4414
"G1100010009803",37,2732,1,5,5,31,2811
"G1100010009804",9,2752,3,5,5,12,2786
"G1100010009805",47,1289,4,6,6,7,1359
"G1100010009806",41,5823,9,1,1,46,5921
"G1100010009807",78,3248,4,24,24,30,3408
"G1100010009808",17,2325,0,2,2,32,2378
"G1100010009809",263,1232,5,9,9,31,1549
"G1100010009810",13,2571,0,1,1,68,2654
"G1100010009820",5,2184,13,3,3,4,2212
"G1100010009901",224,2379,6,9,9,18,2645
"G1100010009902",74,3186,16,2,2,16,3296
"G1100010009903",2,3122,2,0,0,10,3136
"G1100010009904",8,3298,5,0,0,11,3322
"G1100010009905",11,3148,2,2,2,6,3171
"G1100010009906",10,1928,0,0,0,14,1952
"G1100010009907",10,3077,4,1,1,5,3098
